wwwwwwwwwwwwwwww
w..........x..iw
w..A...c...x...w
w..........xx..w
w...........x.cw
w..c.....f..xx.w
w............xxw
w..............w
w.cc........__.w
w.cc.......____w
w.cc.......__..w
w.........._.e.w
w.........._c..w
wwwwwwwwwwwwwwww
