wwwwwwwwwwwwwwww
wc....tttt..cc.w
ww.............w
wwwwwwwwwww....w
w.....c...w...cw
w.e............w
w........._____w
w.c......wwxxxxw
w.c..wwwww.....w
w...ww.......t.w
w...w........tfw
w...w.c..A...tiw
w...w.c......tcw
wwww.wwwwwwwwwww
