wwwwwwwwwwwwwwww
wtt.....w.i...xw
w..w.x.cw.xxwwxw
w...wx..w.w..x.w
w.c...w.w.w.Ax.w
wc.__tw...w....w
wx._.tw.t.....cw
we_.w.w..c..w..w
wx..w...___.w.tw
w...w.cc.._.w..w
w.w.w_._____..ww
wxw..f.www.c..ww
wcw.c........xww
wwwwwwwwwwwwwwww
