wwwwwwwwwwwwwwww
wc_..._ccx....fw
wxcx..._x....._w
w._............w
w..............w
wx.............w
wcx.....tt..x..w
w_..._.eAt.xcx.w
w..._c_.....x..w
w...._.........w
w...........x..w
wx..._._..._c_.w
wix._cxc_..._..w
wwwwwwwwwwwwwwww
