wwwwwwwwwwwwwwww
w_f.........._ew
wi_w.c._..t..__w
w.ww..__c....A.w
w...ww_.t......w
w...ww....cx...w
w.c...ww.x.x.c.w
w..tt.ww.......w
w...c...ww.c...w
w.x.....ww.....w
w...xc._..ww..ww
w.c.x.._c.wwwxww
w....._.....xxtw
wwwwwwwwwwwwwwww
