wwwwwwwwwwwwwwww
wt.tww..x..t.c.w
w.....w._xx....w
w.c.._ww._.xA..w
w.__.cx.._.x.c.w
w...x...xxxx...w
w.c.www_.xcxx_.w
w...w.xw.ww._x.w
w.._...c.xx_.x.w
w.x..e....xww.cw
w.ww....xw__.._w
w..w_..__w.c_..w
w.ciw......__.fw
wwwwwwwwwwwwwwww
