wwwwwwwwwwwwwwww
wccxxxxxxxx..cfw
w..xx..........w
w..xx....c.....w
wxxx...A.......w
w........._...cw
w.........___.cw
wtttttt....__..w
w.....__...._i.w
w...e.._...._..w
w......_...._..w
wc....._.......w
wcc...._......cw
wwwwwwwwwwwwwwww
