wwwwwwwwwwwwwwww
wi.....t.......w
w..A...t.c...ccw
wf.....x.c....cw
wxxxxxxx.cc....w
w..............w
w..............w
w.c........____w
w.cc......__...w
w........._.e..w
w......tt__....w
w......tt_.....w
w......tt......w
wwww.wwwwwwwwwww
