wwwwwwwwwwwwwwww
wi............Aw
w.....c........w
w..............w
w..c........cc.w
w...........cc.w
w.......c......w
w..............w
w...c......c...w
w..............w
wxxx...........w
w__x.........._w
we_x....c...._fw
wwwwwwwwwwwwwwww
