wwwwwwwwwwwwwwww
wf.........xc_cw
w...........xc_w
w............xcw
w.............xw
w......_.......w
w....._x_......w
w...._xcx_.....w
w....._x_......w
w_....._.......w
wc_........www.w
wxc_.......wix.w
wcxc_....._c_eAw
wwwwwwwwwwwwwwww
