wwwwwwwwwwwwwwww
w..............w
w.A......f.cc..w
w.....x....cc..w
w..c.xx........w
w....xxxxx.....w
w.....w..w....tw
w.....w..w....tw
w.....wwww.....w
w.......__.....w
w.cc.i.._....e.w
w.cc...__......w
w.....__...c...w
wwww.wwwwwwwwwww
