wwwwwwwwwwwwwwww
wi......._x....w
w........_xcc..w
w..A....._xxxxxw
w........_.....w
w......c._.....w
w........_.ccc.w
w........_.....w
w........_.....w
w..cc...__.....w
w..cc..._...e..w
w......._......w
w......__.....fw
wwww.wwwwwwwwwww
