wwwwwwwwwwwwwwww
wi......._xc..ew
w......c._x....w
w..A..c.._xxxxxw
w........_.....w
w........_.....w
w.cc....._..c..w
w........_..cc.w
w........_.....w
w..c....__.....w
w......._......w
w......._..c...w
w......__.....fw
wwww.wwwwwwwwwww
