wwwwwwwwwwwwwwww
wf_xi..w.......w
w__xxx.......A.w
w.wwwwww...c...w
w.c....w.......w
w....c.wc......w
w......w....c..w
w......w.......w
w..c...wwwwwww.w
w......w..c....w
w.e...cw.......w
w.wwwwwwwwwwwwcw
w......c.......w
wwwwwwwwwwwwwwww
