wwwwwwwwwwwwwwww
wce.tt.c....t.fw
w....t...tt.t.tw
w.....t.t.t.t..w
w.....t.t.t.ct.w
w.....t...tt...w
wc.....tt..ttttw
w........t..c..w
w........ttttt.w
w............t.w
w....c.....tt..w
wxA........tc._w
wix..c.c....._cw
wwwwwwwwwwwwwwww
