wwwwwwwwwwwwwwww
w......t..._...w
w.t..._..._e...w
w.t._xc_.....t.w
w.._c_x.x...x..w
wfx.x..xcx.xcx.w
w_c_....xc._x..w
w._..x.........w
w..._c_._......w
w...x_xxcx..xx.w
w......._.x_cx.w
w.A......xcx_..w
w.........xi...w
wwwwwwwwwwwwwwww
