wwwwwwwwwwwwwwww
w.._.....c.....w
wc.___.......e.w
w.._c._..._._..w
w_.___._....._.w
w..__.......c_cw
w..__..c.__..__w
w...____...___.w
wc....___......w
w......_..c_...w
w.__c..c.._...Aw
w.__..._____...w
w.i__.__f......w
wwwwwwwwwwwwwwww
