wwwwwwwwwwwwwwww
wc.......__..ccw
w..A......__..cw
w..........__..w
w......c...._..w
w.....c..f..__.w
wc...........__w
w..............w
w..xxx...c.....w
w..xix.....xxxxw
w..xxx.....x...w
w..........x.e.w
wc......c..x...w
wwwwwwwwwwwwwwww
