wwwwwwwwwwwwwwww
w..............w
w..c.....c.....w
w.....c.....i..w
w..............w
w..............w
w..c........c..w
w.....A...c....w
w..............w
w.c.........f..w
w.....c......xxw
w__......c...xcw
we_..........x.w
wwwwwwwwwwwwwwww
