wwwwwwwwwwwwwwww
wAc......w...cew
wcwwwwww.wwwxwcw
w._.fw....i..w.w
wwwwwwwwwwwwww.w
w.....x__w...w.w
w.w..wxc_w...w.w
w.w..wxc_w.....w
wcw..wxx_w...w.w
wwww.wwwwwww.www
w....wc......w.w
w.wwwwww.wwwww.w
w.c..........c.w
wwwwwwwwwwwwwwww
