wwwwwwwwwwwwwwww
w._...w..w...x.w
w._..........x.w
w._.www..www.x.w
w._.w......w.x.w
w._.w._cxx.w.x.w
w._.w.ceix.w.x.w
w._.w.ctfc.w.x.w
w...w.cccc.w...w
w..ww......ww..w
w..w........w..w
w..wx_x_x_x_w..w
wA.w...cc...w..w
wwwwwwwwwwwwwwww
