wwwwwwwwwwwwwwww
w..............w
w.A......__....w
w......._._._..w
w......_.c___..w
w.....___._.c_.w
w...._c..__.._iw
w...._..c._.._cw
w.....___._c_._w
w....___.._____w
w...._.c_c.._c.w
w......____c_..w
w....f__....._ew
wwwwwwwwwwwwwwww
