wwwwwwwwwwwwwwww
wi.....x._.....w
w..A...xc_....cw
wf.....x._....cw
wxxxxxxx._.....w
w...c...._.....w
w_________..c..w
w..............w
w.....c........w
w.c.........e..w
w........c.....w
w..............w
w....c........cw
wwww.wwwwwwwwwww
