wwwwwwwwwwwwwwww
w.x.c.x..x.....w
w.x.x.x...xc.c.w
wxcx......xxx..w
wfx..........x.w
w.xxx..e...xxx.w
w.xcx......x...w
w.xx.x..A...xc.w
w.x.x......x...w
w..cx.....xxxx.w
w.xcxx....xc...w
w..xxcx.i.x.x..w
w.........x....w
wwwwwwwwwwwwwwww
