wwwwwwwwwwwwwwww
w..xxxxxxxx...fw
w..xx..........w
wc.xx........c.w
wxxx...e.....c.w
w........._....w
wc........___..w
wtttttt....__..w
wi....__....___w
w...A.._...._..w
w......_...._..w
wc....._.......w
wcc...._....cccw
wwwwwwwwwwwwwwww
