wwwwwwwwwwwwwwww
wix.........c.Aw
wx.....c.......w
w..............w
w.c............w
w.c...........cw
w.c...........cw
w.....c........w
w..............w
w..............w
w___.......c...w
wxx_...........w
wex_..c.......fw
wwwwwwwwwwwwwwww
