wwwwwwwwwwwwwwww
w............ifw
w..............w
w........c.....w
w..e.c.........w
w......A.......w
w..............w
w.........c....w
w...c..........w
w____...tttt...w
wxxx_...tc.t...w
wccx_c..tt.t...w
wccx_....t.....w
wwwwwwwwwwwwwwww
