wwwwwwwwwwwwwwww
wxxcx.........iw
wxxxx..w.ww..e.w
w....w....w....w
www.w.c..._w...w
ww..w...c..w.c.w
w___.ww.._.w..cw
w.w..__.w...w__w
w..w.....w..w..w
w....A...w..w.xw
ww_ww_..w...w.xw
wccww_w....w.xcw
wcwwf__.xxxxxxcw
wwwwwwwwwwwwwwww
