wwwwwwwwwwwwwwww
wA.....i......cw
w..............w
w...c...__tt...w
w......__..tt..w
w.....___...t..w
wf..___.....x.cw
w...._..cc..x.cw
w...__..cc.xx..w
w....t.....x...w
w....t....xx...w
w....xxxxxx....w
wc..xx.....c..ew
wwww.wwwwwwwwwww
