wwwwwwwwwwwwwwww
wc_..._ccx.....w
wxcx..._x....A.w
w._............w
w..............w
wx.....f.......w
wcx.........x..w
w_.........xcx.w
w...........x..w
w..............w
w...........x..w
w.e.._x_..._c_xw
w..._ccc_..._ixw
wwwwwwwwwwwwwwww
