wwwwwwwwwwwwwwww
w......i.....ccw
w..A.........ccw
w......._www...w
w.c....www.ww..w
w....._w_...w..w
wf..__ww....x..w
w....ww..e..x..w
w...ww.....xx.cw
w....w.c...x..cw
w....w....xx...w
w....xxxxxx....w
wcc.xx.........w
wwww.wwwwwwwwwww
