wwwwwwwwwwwwwwww
wc.........w.c.w
wc...A.....w...w
wc........cw...w
www........w...w
w.www......wxxxw
wi..www....wxxxw
w...__ww...wwxxw
w..w__.ww......w
w..ww_.ew..c...w
w...wwwww....ccw
w..............w
wc......c.....fw
wwww.wwwwwwwwwww
