wwwwwwwwwwwwwwww
wAc..........cew
wcwwwwwwwwwwxwcw
w._..........w.w
w.w..........w.w
w.w...xx_....w.w
w.w...xc_....w.w
w.w...xc_....w.w
w.w...x__....w.w
w.w..........w.w
w.w..........w.w
wcwwwwwwwwwwwwcw
wfc..........ciw
wwwwwwwwwwwwwwww
