wwwwwwwwwwwwwwww
w.fw.....c.....w
wcwwe_..._...c.w
w.w..ww.__w.wc.w
w_._ww._..w.wwww
w.._w.c..w.c.w.w
w.._w.wwww...__w
w..._c__...___.w
wc.A.w.__.ww...w
w.......w..wc.cw
w._wwwww.._....w
w._w..._.w____.w
w.........i....w
wwwwwwwwwwwwwwww
