wwwwwwwwwwwwwwwwwwwwwwwwww
w--x---------------------w
w-------x---xxx-----xx---w
w-----------xxxx----xx---w
w---x-------xx------xx---w
w-----------xx-----------w
w----x-----------...-----w
w------------.......ooo--w
w-------x---........ooo--w
w---x----...........ooo--w
w--------.e....A....oooo-w
w-------............ooooow
wwwwwwwwwwwwwwwwwwwwwwwwww
