wwwwwwwwwwwwwwwwwwwwwwwwww
w--------oo--..--oo------w
w--ooo---xx--..--xx----A-w
w--xxx-------..----------w
w--xxx-------..----------w
w------------....--------w
w..oo....................w
w..oo...............x....w
w..oo.x...x..x...oo.x....w
w..o..x......xx..oo......w
wx......----.....oo......w
wx......----.e...oo...xxxw
wwwwwwwwwwwwwwwwwwwwwwwwww
