wwwwwwwwwwwwwwwwwwwwwwwwww
w..oo......x......x......w
w..xx.w...x..............w
w.....w.x..oo.x.oo..ww.x.w
w.x...w.e..oo...oox.ww...w
w.....w..x....x.oox......w
w...xx.....ww..........x.w
woo......x.ww.....w......w
wooooo.x.......x..w......w
w..x......x.........A....w
w...x..wwwwwww.ooo....oo.w
w................x..oooo.w
wwwwwwwwwwwwwwwwwwwwwwwwww
