wwwwwwwwwwwwwwwwwwwwwwwwww
w...........ooo.....ooo..w
w.xxxxxxw.x.ooo.x...ww..xw
w.xxxxxxw...woo......w...w
w.......w...ww.A..oo.w...w
wwwwwwwww....ww....oow.x.w
w.....ooo.x...ww...xoo...w
w......ooo.....ww...oow..w
w...e...wwwwwoo..w...ww..w
w...........woo.....ww.x.w
w.x...x.....woo...oow....w
w.............o.x.ooo..x.w
wwwwwwwwwwwwwwwwwwwwwwwwww
