wwwwwwwwwwwwwwwwwwwwwwwwww
w..o.o.o.................w
w.xw.ow..x..ooooo.o....w.w
w...o.xx...........oo....w
w....o...x-.xxwwxwwww..w.w
www.ww.w..-xww.....xxw...w
www.....--w.w..x....xw.w.w
w.ww..---x..w....ex..w..xw
w-..ww-.w...w........w.xxw
w--..--..www..x...x..w.x.w
w..--..........oo....oxx.w
w.....A..................w
wwwwwwwwwwwwwwwwwwwwwwwwww
