wwwwwwwwwwwwwwwwwwwwwwwwww
w...........xx.xx.xx.....w
w....A...................w
w......o........o........w
w...............o......e.w
w...........o.....o......w
w....ooooo........o......w
w....ooooo....xxx.oo..xx.w
wxx..ooooo....xx...o..xx.w
wxx......................w
wxx................xx....w
w.............ooo........w
wwwwwwwwwwwwwwwwwwwwwwwwww
