wwwwwwwwwwwwwwwwwwwwwwwwww
wxx..xxx.....xxx.........w
wxx........oo........ooo.w
w..o.......oo....x...ooo.w
w..o.....................w
w..o...x...x.............w
w..o..............x.A.---w
w.............x...x...---w
w.................x...---w
wxx..oooo...........-----w
w...........xxxx...------w
w.....e...........-------w
wwwwwwwwwwwwwwwwwwwwwwwwww
