wwwwwwwwwwwwwwwwwwwwwwwwww
w..o.o.o.................w
w.xw.ow..x..wwwwo.o.xx.w.w
w....w.x.xww....w..o.....w
w....o...x..xx.ooww....w.w
w.w.x..w...wwo...w..xw...w
w.w.....-..ww..x.wx.ww...w
w.ww..--.x.w...o.www.....w
w-.x.w......w....ww..A..xw
w--..x-.xxoo..x...x......w
w........x...oooo....o...w
w.....e...x..............w
wwwwwwwwwwwwwwwwwwwwwwwwww
