wwwwwwwwwwwwwwwwwwwwwwwwww
w..x............x........w
w..x...xxx...........x.x.w
w..........wwww.....w....w
w................A.......w
w...www.....w.---........w
w.x.....xx..w.---.xx..w..w
w.xxx...x....w.--........w
w.x..........w...ww......w
w.x..........w...w....w..w
w..e...ww...ooo....xx.w..w
w......w....ooo....xx.w..w
wwwwwwwwwwwwwwwwwwwwwwwwww
