wwwwwwwwwwwwwwwwwwwwwwwwww
w........................w
wxx...x...w....x.........w
wxx..A....w.x..x...wwwwwww
w.........w.......ww.....w
w.........w..w...ww......w
w.www........w...w....x..w
w...ww...x...w...w.......w
w....www.....w...x...e...w
w......ww....w..........xw
w............w......xx.x.w
w.xxxx.......w..x...xx.x.w
wwwwwwwwwwwwwwwwwwwwwwwwww
