wwwwwwwwwwwwwwwwwwwwwwwwww
w..................-----ow
w....x.............-----ow
w..e.x............---xx-ow
w....x........-xx----xx-ow
w.........A.---xx----xx-.w
w............------------w
w............------------w
w..ooo.....--------xxx---w
w..ooo....--xxxx---xxx---w
w......------------------w
w......-----------ooooo--w
wwwwwwwwwwwwwwwwwwwwwwwwww
