wwwwwwwwwwwwwwwwwwwwwwwwww
w..oooo...w......w.......w
w..xxxx...w......w.......w
w.........w..xx..w.....x.w
w...A.....w..xx..w.....x.w
w....oo...w......w.......w
w....xx..........w..x....w
w.x..............w.......w
w.x..oo...w..xx..w.......w
w...eooxx.w..xx..w.......w
w....ooxx.w..............w
w....oo...w..............w
wwwwwwwwwwwwwwwwwwwwwwwwww
