wwwwwwwwwwwwwwwwwwwwwwwwww
w............A......xxx..w
w.ww.owwwwww.wwwww..--...w
w.w.oo.o..w.w.....w......w
w.w..oo.xxw...xx.....w...w
w.w.o.w..x..oox..w..o.ww.w
w..w..wwx...oo....x....w.w
w..w.wx.w.w.wo..ww.o.w.www
wxxw......w..owww.o...ewww
w.x...xxx.ww...wwwwwwww.ww
w.......x...........-o-..w
w...w........xx...ox...x.w
wwwwwwwwwwwwwwwwwwwwwwwwww
