wwwwwwwwwwwwwwwwwwwwwwwwww
w......o...xx.....e...x..w
w......o...x..o..........w
w..x--..x.w.o.-..ooo.....w
w........--.-.-w-..o.oo..w
w...oow.x-x...o-...o.-o..w
w..oxo.o..x...x.-.o-xo...w
w..w.x...o.x--..--x-oo...w
w-..o-.w..-o...x.--oooxx.w
w...oo---...o.o.oox.ww...w
w...Ao.........o.........w
w...........xo...xx.x....w
wwwwwwwwwwwwwwwwwwwwwwwwww
