wwwwwwwwwwwwwwwwwwwwwwwwww
w......o...xx.....x...w..w
w.x.wx...x....--..x.xxwx.w
w........w.w.-...wwo.ow..w
www.ww..w.ww...w....www.xw
w...w........x......ww.x.w
w-..xwx....wx.w.ww.w.w.x.w
w-.-...xo..wx..w.-...ww..w
w..w......wwxw....x..ww..w
w..-wwww.w..x..wwww.www..w
w.--A.ww.w..x.......w.o..w
w...e..........o.o.o.....w
wwwwwwwwwwwwwwwwwwwwwwwwww
