wwwwwwwwwwwwwwwwwwwwwwwwww
wA..wxo.wxw.wx..w.ox.xw.xw
wwwowwwoo.w..owww.wwwwwwow
w.w.w.o.w.w.w.w.w.w.w....w
w.w.w.w.w.o.w.wxw.o.w.w..w
w.wxwxw.w.wxw.w.wxw.w.wx.w
w.o.w.w.wxw.w.w...w.wxw..w
w.w.w.w.o.w.w.o.w.w.w.w..w
wxw...w.w.o.w.w.w.w.w...xw
w.w.w...w.w.w.wxw.o.w.w..w
wowwwwwowww.wwwww.www.wwow
wx...xwxw.wxwx..o..xo.w.ew
wwwwwwwwwwwwwwwwwwwwwwwwww
