wwwwwwwwwwwwwwwwwwwwwwwwww
w..................oo....w
w.xx....A.x........oo....w
w.........x........oo..xxw
w..............xx......xxw
w......................xxw
w.x..oo..x...............w
w.x..oo..xx..oo..........w
w........x...oo..........w
w........................w
w....xx.xx.x.........e...w
w........................w
wwwwwwwwwwwwwwwwwwwwwwwwww
