wwwwwwwwwwwwwwwwwwwwwwwwww
w........................w
w.....xxxx..........x....w
w.....xxxx...x..--..x.....
w..x...........----.x....w
w..x.......--------.x....w
w.......---------------..w
w.....e.....--------.....w
w.....xx.......----.xx...w
w..x.........x..----xx...w
w........A......--.......w
w........................w
wwwwwwwwwwwwwwwwwwwwwwwwww
