wwwwwwwwwwwwwwwwwwwwwwwwww
w...................o..-xw
w.---www.o-x-.-xo...ww--.w
w..-.......-.--oooo.o..-.w
w.---.x-xx.x-.o--oo-o.-o.w
w.--oxxo.oo-.xx--...-x--.w
w.o-wx-..-..ooo--A-..o-..w
w.o..--w-e..x-o---w.-.ox.w
w.o.x.o...-x-o-..---w.o-.w
w.xxx....--..-o----oo-...w
w...-o.o-....oooo-.o.o.xow
w.......-x.....o.o......xw
wwwwwwwwwwwwwwwwwwwwwwwwww
