wwwwwwwwwwwwwwwwwwwwwwwwww
w.....xxx................w
w.oox.........o.xx..A...xw
wo........wwwwwwwwwwww...w
wo....x..ww...ww.x...www.w
w.w.o.xo.w......x.xx...w.w
wow.....o...o.......x..w.w
w.o..oxx....o....w..x..w.w
w.oooxx...w...x.......ww.w
w..ooo...www....wwwwwww..w
w..w.ooo......www.e..x.o.w
w...wwwoowwwwww....xx....w
wwwwwwwwwwwwwwwwwwwwwwwwww
