wwwwwwwwwwwwwwwwwwwwwwwwww
wxx....o......----ooo....w
wxx....o...A..---.oooo...w
w......o......---.........
w.............---.xxx....w
w....x....xxx.---.xx.....w
w....x........--..x..----w
w....x....xxx........---.w
w..............oooo..-...w
w.xx...ooooo...ooo.....e.w
w.xx...........ooo.......w
w........................w
wwwwwwwwwwwwwwwwwwwwwwwwww
