wwwwwwwwwwwwwwwwwwwwwwwwww
w.................x.w....w
w..xx..........x....w....w
w.......A...x.....x.wxx..w
wwwwwwwwww..x.......wxx..w
w............wwwwwwww....w
w........................w
w...xxx..w......w.....e..w
w...xxx..w...xx.w........w
w........w..wwwww..xx....w
w........w.........xx....w
w........w...............w
wwwwwwwwwwwwwwwwwwwwwwwwww
