wwwwwwwwwwwwwwwwwwwwwwwwww
w.x........w.......x.....w
w.x...e....wxx...........w
w..........w.........A...w
w..........w....x........w
w......x...w..........oo.w
w.........xwwwwwww....oo.w
w..................x.....w
w..xxx.w........x..x.....w
w..xxx.w.xx....xx......x.w
w..........wwwwwww.....x.w
w............oooo........w
wwwwwwwwwwwwwwwwwwwwwwwwww
