wwwwwwwwwwwwwwwwwwwwwwwwww
w.......----....x.......xw
w.xxx.................A..w
w.x.....x..xxx.--.........
w...x...x......--.o......w
w...x......ooo.-..o...x..w
w.---......ooo....o.o.x..w
w.---...oo.---..x...o....w
w....e..oo......x...o....w
w.......---..............w
w.xx........xx...........w
wx......................xw
wwwwwwwwwwwwwwwwwwwwwwwwww
