wwwwwwwwwwwwwwwwwwwwwwwwww
wxxxx....................w
wxxxx.............xx.....w
w.......A.........xx.....w
w.................xx.....w
w..........x......xx.....w
wx.......................w
wx.......................w
w........................w
w.......e........x.......w
w........................w
w..xxx...................w
wwwwwwwwwwwwwwwwwwwwwwwwww
