wwwwwwwwwwwwwwwwwwwwwwwwww
wxx........o...........x.w
wxxoo.x.........x...x.w..w
w..oow....x.wo....x......w
w..o.w..w............w...w
w....w..w.xwww.ww.wwww...w
w.-..wx...w.............xw
w.x..w..e.w........o.....w
w....ww..ww...x....w.....w
w.ww..wwww..A...x....x.x.w
w-.x...o...............-xw
w-....oo.......x....o.-xxw
wwwwwwwwwwwwwwwwwwwwwwwwww
