wwwwwwwwwwwwwwwwwwwwwwwwww
wx.....o.........-.....--w
w...x.o.-x...www.o-w--.x.w
w..xoo--.wo.xwwx-xoo--.-.w
w.---.o-.w---o.o.--.x.o-.w
w.-.x.x--....--o.A-.-.w-.w
w.-o--oxoo...-.-.--w-.---w
w.o---o.x....--x.---.-..xw
w-ox----.-x-.----wx-.-...w
we..ww--....-..-...-.ooo.w
w.-.x.wwwwww--w..x.-o-x..w
w........x......ox...o...w
wwwwwwwwwwwwwwwwwwwwwwwwww
