wwwwwwwwwwwwwwwwwwwwwwwwww
w..................w.....w
w.oo.oo....A...x...w.....w
w.oo.xx..........x.w.x...w
w....................x...w
w..x..wwwwwwww....oooo...w
w..x...xxx....x..........w
w......xxx....x...w......w
w...e...w.........w...x..w
w.......w.xx......w.x....w
w.xxx...w.........w......w
w.......w................w
wwwwwwwwwwwwwwwwwwwwwwwwww
