wwwwwwwwwwwwwwwwwwwwwwwwww
w....x...................w
w..x.x...e..xxxxx...--.x.w
w-......-----.......x....w
w..wwwwwwwwwwwwwwwwww....w
w..-.w.......x..x......x.w
w.x--w.x.................w
w..--w--wwwwwwwwwwww.x...w
w....w--..x------........w
w..x.......--w---..A...x.w
w.....x....--w---x.......w
w........x..-w--....x....w
wwwwwwwwwwwwwwwwwwwwwwwwww
