wwwwwwwwwwwwwwwwwwwwwwwwww
w..x..oo.....w..o..x.x...w
w..x..xx.....w..x..x.x...w
w........ooo...........o.w
w........ooo...........x.w
w..wwwwwwwwwwwwwwwwwwww..w
w........................w
w.ooo....oo....x.oo.e....w
w.xxx....oo..w...oo......w
w.xxx..A.oo..w.......xx..w
w........oo..w...xx..xx..w
w............w...........w
wwwwwwwwwwwwwwwwwwwwwwwwww
