wwwwwwwwwwwwwwwwwwwwwwwwww
w.......o.....w...w......w
w....A.oo..x.ww....w..x..w
w.o.x...o....w...x.www...w
wooo..w..x......oo...ww..w
w.oo..www....xx.oo.x..ww.w
w.o.xx..www......o.......w
w...xxx..oooo.wwwowwwww..w
wwwww......x.ww...e...x..w
w...ww..x...wwx.oo.......w
w.x.www.x..ww...oo.xxxx..w
w...............oo.......w
wwwwwwwwwwwwwwwwwwwwwwwwww
