wwwwwwwwwwwwwwwwwwwwwwwwww
w---x-----x------x------ew
w-------x----------------w
w--A----xx---------------w
w------------xx----x---x-w
w------------------------w
w--x-------xx-----x------w
w-----xx----------------.w
w-----x--xx-----------...w
woo---x--------x----x-...w
woox-------------........w
woo--------------........w
wwwwwwwwwwwwwwwwwwwwwwwwww
