wwwwwwwwwwwwwwwwwwwwwwwwww
w..........x.....o.......w
w..x.............x...x...w
w.....A..ooo....o..w.....w
w........ooo....o..w.....w
w...wwwwwww.www....w..x..w
w..............o...w..x..w
w..x......x....x...w.....w
w..x.xxxx.........o.e....w
w....xxxxo..ww....x......w
w........o..ww...........w
w........o....xxx......x.w
wwwwwwwwwwwwwwwwwwwwwwwwww
