wwwwwwwwwwwwwwwwwwwwwwwwww
w-------------------x----w
w---x-------x--------x---w
w--x----x----------------w
w------------------------w
w---------------e----xx--w
w---x--x-------------xx--w
w---x-----x----------xx--w
w---------x--xx----------w
w--------xx--xx-----A----w
w------------------------w
w------------------------w
wwwwwwwwwwwwwwwwwwwwwwwwww
