wwwwwwwwwwwwwwwwwwwwwwwwww
w.xx.........xx..........w
w.......www............x.w
w.o.w.....w.wwwwwwww.w.x.w
w.x.w..ooo.A......x..w...w
w...w..xoo....x......w...w
w.o.....oo...........w...w
w.x....wwwwwwwwww........w
w.....xxxx..oooo......x..w
w...........w.....xx..x..w
w...e..ww...w.....xx.....w
w...........w.....xx.....w
wwwwwwwwwwwwwwwwwwwwwwwwww
