wwwwwwwwwwwwwwwwwwwwwwwwww
w-------------------xxxx-w
w--xx--xx----------------w
w--xx--xx----------------w
w------------x-----------w
w------------x-----------w
w------------x---x-------w
w------------x---xxx-----w
w---x--------x-----------w
w------------x-----------w
w------e-----------------w
w----------------------A-w
wwwwwwwwwwwwwwwwwwwwwwwwww
