wwwwwwwwwwwwwwwwwwwwwwwwww
w...........o..o..oo.....w
w.x......w..x..x..xx.....w
w....A...w.oo............w
w..x...x.w.xx..w....wwww.w
w........w.xx..w.oooo....w
w........w.xx..w.xxxx....w
w.wwww...w.....w.....e..ow
w......x.w..oo.w........xw
w........w..oo....ww.oo.xw
w.x......w.x..x.o.ww.oo..w
w...............o....oo..w
wwwwwwwwwwwwwwwwwwwwwwwwww
