wwwwwwwwwwwwwwwwwwwwwwwwww
wxx..oo...xxx............w
wxx..--...........xx.e...w
w....--...........x......w
w...........x............w
w.......x................w
woo......................w
w--.............ooooo...xw
w--.............-----...xw
w--...A....x....-----....w
w-x.............xxxxx....w
wxx......................w
wwwwwwwwwwwwwwwwwwwwwwwwww
