wwwwwwwwwwwwwwwwwwwwwwwwww
w......o....o..o..wwwww--w
wo..ox..x...x...-woo-ww.-w
w--.o..o..xwo.wox-x..---.w
w-owww--w.x--....-..w.-wxw
w-...ww--.x-o--w--x.o.x-ow
w-x.w-w-oo--x.o-xx...ww-.w
w.-x-owo.----.x.-..o.o-.ow
wx..x-oww-.oo-x----.w-o.-w
w..o..w..ww-ww-w--x--oow-w
w-owooew.w....---A-xx.o.-w
w--..w---o..w..w.........w
wwwwwwwwwwwwwwwwwwwwwwwwww
