wwwwwwwwwwwwwwwwwwwwwwwwww
w...................x....w
w...A........www..x......w
w..........w..x......xx..w
w..........w..x..w.......w
w...wwww...w.x...w..wwwwww
w..........w.x..ww.x.....w
w..........w....w....e..xw
w..........w.............w
w.....www....w....xxx...xw
wxxx......xx.w....xxx....w
w.x......................w
wwwwwwwwwwwwwwwwwwwwwwwwww
