wwwwwwwwwwwwwwwwwwwwwwwwww
w...w.xw.................w
w.wx...wxx.....x....x....w
w.wwo..wxx..ooo.......o..w
w....w.wwwwwwxo..www..ox.w
w........x...xo.x..w..ooow
w.x..w......w......w..x..w
w.w..w.....w...xwoo......w
w....wx....w....wx.......w
wwww.www..xw....w...x....w
w.Ao.......wx.x........x.w
we.o.......w.............w
wwwwwwwwwwwwwwwwwwwwwwwwww
