wwwwwwwwwwwwwwwwwwwwwwwwww
w......oo.o......oo......w
w......xx.o...oo.xx......w
w.x.w..xx.o.w.oo....e..x.w
w...w.....o.w..........x.w
w...w.......w............w
w.o.wwwww...w...wwwwww...w
w.x.w.......w....wwww....w
w.x.w....A..w..........x.w
w...w..ooo..w.oooxxx...x.w
w......xxx....oooxxx.....w
w......x.................w
wwwwwwwwwwwwwwwwwwwwwwwwww
