wwwwwwwwwwwwwwwwwwwwwwwwww
wxx.......x..o...x....x..w
w..o.o...................w
w.o....o........o.....A..w
wx.o.......x........x....w
wx.......................w
wx.....o.....ooo.........w
w............ooo..ooo..x.w
w...e..xx.xx..........xx.w
wxx...................xx.w
wxx.......o...o...o......w
w.....o..................w
wwwwwwwwwwwwwwwwwwwwwwwwww
