wwwwwwwwwwwwwwwwwwwwwwwwww
w......o.......oo.wwwoo--w
wo..ox..xx..x...wo..woo.-w
w--.o..o..xww.wwwww.o..x.w
w-ow.w--w..x-owo.e.ww.-x.w
w-..oww--.x-ow-w--x.oo...w
w-...ow-.oo-x.o-wx.o.ow-.w
w..x-o.o.--o-...-o.wwo-.ow
wx.xx.oww-.oo-xo--w.w-o.-w
w..o..xooww-oww.wwx--.ow-w
w-oxxoxw.oo...-.....x.o.-w
w--..w---o..w..w..A......w
wwwwwwwwwwwwwwwwwwwwwwwwww
