wwwwwwwwwwwwwwwwwwwwwwwwww
w..o.o.o...............xxw
w....o...xx...www...xx.x.w
wx...w..x.w.......oooo...w
w..wwo.xx..w..w.o.....ww.w
wx.w.ooox.w..o..o...xw.w.w
wx.ww..oxx.w..wwwwww...w.w
w.....-.oo.w........e..w.w
w...w....oow.....x.....wxw
w.....w.........x.x..w.o.w
w..A...w.w..wo.oow.....o.w
w.........x..........x.o.w
wwwwwwwwwwwwwwwwwwwwwwwwww
