wwwwwwwwwwwwwwwwwwwwwwwwww
w........................w
w..xx...x....A...........w
w.......x............x....
w..xx............x...xx..w
w................x.......w
w..x........x............w
w..x.................xx..w
w..x.................xx..w
w....................xx..w
w......e......xx.........w
w........................w
wwwwwwwwwwwwwwwwwwwwwwwwww
