wwwwwwwwwwwwwwwwwwwwwwwwww
w......o.-o.o..o..ooo---xw
woooooo--o-...ooo-..w---ow
wo.-xxoooooox.-oo.-.o..-.w
wo--..--w.oox-o-x.-.o.-o.w
wo-..-wo..o-wxo-.o..-.o-.w
wo-.xxo.o..--..x.--.-x...w
wo..e-ow-...----...x..-o.w
wo..-.x.x.o-xo-ww.......xw
w.o..o...-Axo-ox-..wo-o..w
w-ooooooo-owxwxwwwww.o-.-w
w--..w----.xxx.o.o.......w
wwwwwwwwwwwwwwwwwwwwwwwwww
