wwwwwwwwwwwwwwwwwwwwwwwwww
w........................w
w.x..x..xxx.....x......x.w
w.x.....xxx............x.w
w............xxx...A.....w
w........................w
w......wwwwwwwwwww.......w
w....x............wwwwwwww
w............xx..........w
w..xx......e....x........w
w.....................x..w
w.......x................w
wwwwwwwwwwwwwwwwwwwwwwwwww
