wwwwwwwwwwwwwwwwwwwwwwwwww
w.xe..........x....w.....w
w.....x....ww.........w..w
w..........x...w.x..www..w
w...wwwwww.....w.........w
w..ww...x....w.www...x...w
wwww......w..w..ww.......w
w......wwww.........w....w
w.x.Ax.ww..x..x..x.ww....w
w......ww........x....xx.w
w.x..x.w.....wwww.xx..xx.w
w..........x......x......w
wwwwwwwwwwwwwwwwwwwwwwwwww
