wwwwwwwwwwwwwwwwwwwwwwwwww
w.....x..................w
w..x...........x....x....w
w.......xx...............w
w....x.......x.........x.w
w........x...x..x........w
w.x..x................x..w
w..............x.........w
w.....x..........x.......w
w.........x.........x....w
w.A.........x.x........x.w
we.......................w
wwwwwwwwwwwwwwwwwwwwwwwwww
