wwwwwwwwwwwwwwwwwwwwwwwwww
w......xx.....w..........w
w......xx.....w....x...A.w
w.............w....x.....w
w.xx..........w..........w
w.wwwwwwww..x.w.......x..w
w...........x.w...wwwwwwww
w....e.......ww.......xx.w
w............ww..xxx.....w
w................xxx.....w
w....xxxx................w
w........................w
wwwwwwwwwwwwwwwwwwwwwwwwww
