wwwwwwwwwwwwwwwwwwwwwwwwww
w.....w..................w
w...x.w..x....x..........w
w.....w............x...x.w
w.A...w....x...w.........w
w.....w........w.....x...w
w...x.w.........w........w
w.....w.....xx..w......x.w
w...........xx..w.x......w
w.xxx.......xx..w........w
w.xxx...........w..x..e..w
w...............w........w
wwwwwwwwwwwwwwwwwwwwwwwwww
