wwwwwwwwwwwwwwwwwwwwwwwwww
w......o........x........w
w.....x.........x..ww....w
w......x..w..w....xx..x..w
www....ww.ww...w..x......w
w....ww.x.x........w.w.x.w
w-.www..w...wwx.www..w...w
w-.ww.e.....xx...-.......w
w..wwwwwwww..w........x..w
w.......x.wwwww.w.wwwwx..w
wx..A...xw.o.x.oo........w
w...........oo.o.x..xx...w
wwwwwwwwwwwwwwwwwwwwwwwwww
