wwwwwwwwwwwwwwwwwwwwwwwwww
w.ooo....................w
w.x.x...wwwwwwwwwwww..w..w
w.x.x.......e..w.oo...w..w
w........xx....w.xx...w..w
w..x.....xx....w.......o.w
w......wwwwwwwwwwww....x.w
w.........x............x.w
w................oo....x.w
w..xxx.....x...x.oo.A....w
w..xxx...........oo......w
w........................w
wwwwwwwwwwwwwwwwwwwwwwwwww
