wwwwwwwwwwwwwwwwwwwwwwwwww
w........................w
w...xx.x.........xxx.....w
w...x............xx......w
w......e.........xx......w
w........................w
w...........xx...........w
w....xx...............x..w
w....xx...............x..w
w....xx......xx..........w
w..A.....................w
w........................w
wwwwwwwwwwwwwwwwwwwwwwwwww
