wwwwwwwwwwwwwwwwwwwwwwwwww
w.o........oo.........oo.w
w.x........xx....w.e..xx.w
w.x..............w....xx.w
w....A.........o.w....xx.w
w..............o.ww......w
w.....wwwwwww....ww......w
w..............w.....oo..w
w......ooo....ow.o...xx..w
w.x....xxx....xw.x.......w
wooo...xxx....xw.x.wwwwwww
wooo...........w.........w
wwwwwwwwwwwwwwwwwwwwwwwwww
