wwwwwwwwwwwwwwwwwwwwwwwwww
w.o........oo..w......oo.w
w.x........xx..w......xx.w
w.x............w......xx.w
w......A.......o......xx.w
w..............o.........w
w..........wwwwwwww......w
w...w................oo..w
w...w..ooo....o..o...xx..w
w.x.w..xxx....x..x.......w
wooow..xxx....x..x....e..w
wooow....................w
wwwwwwwwwwwwwwwwwwwwwwwwww
