wwwwwwwwwwwwwwwwwwwwwwwwww
w......w.....xxxxx.....wxw
w.xx...w..x.........A..wxw
w.xx...w..x...ww.......wxw
w.xx.......oo..ww......wxw
w...........ooo.www..xx..w
w...wwwwwwwwooo...ww.....w
w...................ww...w
w.xx..........w..---.....w
w.xx...e..w...w..---.....w
w.............w..-------.w
w.........w.......-------w
wwwwwwwwwwwwwwwwwwwwwwwwww
