wwwwwwwwwwwwwwwwwwwwwwwwww
w---------------------A--w
w------------------x-----w
w-----xxxx--------xxx----w
w-----xxxx--------xxx----w
w------------------------w
w------------------xx----w
w---------xxxx-----xx----w
w------------------------w
w------------------------w
w------e-----------------w
w--------------ooo-------w
wwwwwwwwwwwwwwwwwwwwwwwwww
