wwwwwwwwwwwwwwwwwwwwwwwwww
w...................o...xw
w.xxwwww.o.x-.oxo...ww.x.w
w..w.........--o....w....w
w.....o..x..o.x--oo-...o.w
w..oo..o.oo....xo...-x-..w
w.o.w.o..w..o..ox.o...x..w
w.o..o.w....o.o.xxw.o..x.w
w.o...o.A.oo..w...o-w....w
w..oo..oo...e...x.xo.-...w
w.xxxo.oo.o..o..x....o..ow
w.x......x.......o.......w
wwwwwwwwwwwwwwwwwwwwwwwwww
