wwwwwwwwwwwwwwwwwwwwwwwwww
w......o...xx.........x..w
w..........x.............w
w..x--..x.w...-...A......w
w........--.-.-w-....x-..w
w...x-w.x-x...--.....-...w
w..-x-....x...x.-.--xw...w
w..w.x...-.x--..--x-.....w
w-..w-.w..-....x.---..xx.w
w.....---.......-.x.ww...w
w...e...x......o.........w
w............o......x....w
wwwwwwwwwwwwwwwwwwwwwwwwww
