wwwwwwwwwwwwwwwwwwwwwwwwww
w------------------------w
w-----A-----------x------w
w--------------------x---w
w--x--x----x-------------w
w--------------x----x----w
w----------------x-------w
w--x--x-x---x------------w
w---------------xxx------w
w--x--x------x--xxx--e---w
w---------x----x---------w
w------------------------w
wwwwwwwwwwwwwwwwwwwwwwwwww
