wwwwwwwwwwwwwwwwwwwwwwwwww
w........--.......-.----xw
w.----o--o-x-.ooo-..w---.w
w-.-xxooooooxx-oo--eo..-.w
w.--xo--w-ow--o-xx--o.-o.w
w.--o-w--x--wo---oox-x--.w
w--oxx-...---wooo--.-x-..w
w--ox--w-...------w.x.--.w
w--o-.x.x.--oo-w.-A-w.-.xw
w----....---o-oo-oooo-o..w
w--wwo.o--.wo-oo--xo.o-x-w
w--..w----.....o.o.....-xw
wwwwwwwwwwwwwwwwwwwwwwwwww
