wwwwwwwwwwwwwwwwwwwwwwwwww
w........w....xx...xxx...w
w........ww......wwwwww..w
w...w.....w...wwww.A....xw
w...w.xx..w.............xw
w...w......oo..xx...ww...w
w...w......oo............w
w...ww..wwwwwwwwwwwwwww..w
w....w...ooo......oo.....w
w........xxx......oo..xx.w
w..xx....xxx...e..oo..xx.w
w.................oo.....w
wwwwwwwwwwwwwwwwwwwwwwwwww
