wwwwwwwwwwwwwwwwwwwwwwwwww
w...w.xw.................w
w.wx...w.......x....x....w
w.wwo..wxx..ooo.......o..w
w....x.wwwwwwxo..www..ox.w
w........x...xo.x..w..ooow
w.x..x......w......w..x..w
w.w..w.....w...xwoo......w
w....wx....w....wx.......w
wwww.www..xw....w...x....w
w.Ao.......wx.x........x.w
we.o.......w.............w
wwwwwwwwwwwwwwwwwwwwwwwwww
