wwwwwwwwwwwwwwwwwwwwwwwwww
w.......x.oo.............w
w..oo......o...x.......A.w
w..ox.....................
w...................x....w
w......xxxxxxxx.....xxx..w
w..e............oo..x.x..w
w.......ooooo...oo.......w
w..ooo..........o........w
w..xoo...x...x..o..x.....w
w..ooo.......x...........w
w..oox.............ooooo.w
wwwwwwwwwwwwwwwwwwwwwwwwww
