wwwwwwwwwwwwwwwwwwwwwwwwww
w.....x..................w
w.ox...o.......x....x....w
w.ooo..oxx..ooo.......o..w
w....x.ooo...xo.......ox.w
w........x...xo.x.....ooow
w.x..x................x..w
w....o.....o...xooo......w
w....ox....o....ox.......w
wooo.ooo..xo....o...x....w
w.Ao.......ox.x........x.w
we.o.......o.............w
wwwwwwwwwwwwwwwwwwwwwwwwww
