wwwwwwwwwwwwwwwwwwwwwwwwww
wx.........o..x........x.w
w...o...x.......x...x.w..w
w.........x.wo....x......w
w.x..ww.x......x.....w...w
w....w.....x.....x.wwwe..w
w.-x.ww.....xw.w........xw
w.ooo...ww.......wwwww...w
w..ooow...x..w.....w.....w
w..ooo......ww.x..x..x...w
w-.x.oo....Awww..x......xw
w-....oo......ww....o....w
wwwwwwwwwwwwwwwwwwwwwwwwww
