wwwwwwwwwwwwwwwwwwwwwwwwww
w.oo...xxx.w..oo.........w
woo........w...ox.....w..w
w..A....x....x.ox..x.....w
woo.........x........w...w
woo.wwwww...oooo....w..w.w
w.........xx.o....x....w.w
w..w..xx.......www...x...w
w..ww.xx..xx......w..x...w
w............x.o.ww......w
w..xx....w..oooo.w....e..w
w........w..oooo.........w
wwwwwwwwwwwwwwwwwwwwwwwwww
