wwwwwwwwwwwwwwwwwwwwwwwwww
w....ooo................xw
w..xx.....w..............w
w.........w......x.......w
w.........wx.....x...xxx.w
w.x....A..w........wwwwwww
w.x.......wx.............w
w.........w..............w
w.........woooo......e...w
w...xxx...wooooxx........w
w...xxx..................w
wx..................xx...w
wwwwwwwwwwwwwwwwwwwwwwwwww
