wwwwwwwwwwwwwwwwwwwwwwwwww
wx.................--....w
w....A.............--x...w
w.............xx...--x....
w.............xx...---...w
w.....xxxx...............w
w.............oo...---...w
w.............oo...---...w
w........xxxx.oo...---.x.w
w.xxxx........oo.e.---.x.w
w.............oo.........w
wxx...........oo.........w
wwwwwwwwwwwwwwwwwwwwwwwwww
