wwwwwwwwwwwwwwwwwwwwwwwwww
w...........ww...x.......w
w..x.xx.....w...x.....x..w
w..x....A...w......ww....w
w...........w.....ww.....w
w....x.ooo.ww.oo.ww...xx.w
w.x.ww.ooo.w..ooww....xx.w
w....www.....x.ow........w
w......ww......ow....e...w
w.......wwwoo..o.........w
w.x.........oowwwwwwwooo.w
w...x........oxxxxxxxo...w
wwwwwwwwwwwwwwwwwwwwwwwwww
