wwwwwwwwwwwwwwwwwwwwwwwwww
w...x.....w.oo...........w
w.x.......w.oo.....x.x.oow
w.....A...w.oox........oow
w.........w.....xxx......w
w..x...x..........wwwwwwww
wwwwwww...x.x......x.....w
w.......x.......w........w
w...............w.......xw
w...xx.....x....w...e...xw
w...xx...x......w.x..oooow
w...............w....oooow
wwwwwwwwwwwwwwwwwwwwwwwwww
