wwwwwwwwwwwwwwwwwwwwwwwwww
w....w....ooo........xxo.w
w.oo.ww..xooo..x.ww..xxo.w
w.oo..w........xx.ww...o.w
w.....ww..x..w..x..ww....w
w......w..x..ww.x....xx..w
w.x....ww.x...w....oooo..w
w.......w.x...w..........w
w....x..w.xoo....wwwww...w
w..........oo....o....xx.w
w...e......oo....o.A..xx.w
w................o.......w
wwwwwwwwwwwwwwwwwwwwwwwwww
