wwwwwwwwwwwwwwwwwwwwwwwwww
w........................w
w.............xx.........w
w..xxxxx......xx.A........
w........................w
w..............xxx...x...w
w...xx...............x...w
w...xx...............x...w
w........................w
w.......xxxx.............w
w.............e..........w
w........................w
wwwwwwwwwwwwwwwwwwwwwwwwww
