wwwwwwwwwwwwwwwwwwwwwwwwww
w..........ooo...........w
w.......xxxooow....A...x.w
woo....www....w.....w..x.w
woo.xx.w..x..x.wx...www..w
wo..xx.w..x..x.wx.....w..w
wowwwwww.......oo..w.x...w
w.......xx...x.oo.ww.....w
w........www...oo.w......w
w...x...wwe....x.wwoox...w
w...x..ww...ooo..w.oo....w
w...........oooo...oo....w
wwwwwwwwwwwwwwwwwwwwwwwwww
