wwwwwwwwwwwwwwwwwwwwwwwwww
wx.......................w
wxx....o.e....o.o....x...w
w.....ww..ww..oo....o....w
w.o..xxw..o.w.ooo.x..o.o.w
w....xw.o.o...o.o.o..oox.w
w..o..o...o..oo...x......w
w...xw..o.o.ooo...o.o..x.w
w.o..x...o....o...xxxx...w
w..ww.xx...x.oooox...ooo.w
w..ww...Ao...ox.x.o.ooo.ow
w....o...oooo....o.......w
wwwwwwwwwwwwwwwwwwwwwwwwww
