wwwwwwwwwwwwwwwwwwwwwwwwww
w.....A........------w.w.w
w...............-----wxw.w
w.x.....x..w.....----wxw.w
w.x.....x..ww.xx..--.w...w
w..........ww.....--.w...w
w...wwwwwwwww.....-......w
w........x.wwxx..........w
w..xxx...x.wwxx....e.....w
w..xxx......w.........x..w
w...........w..ooo...xx..w
w...........w..ooo.......w
wwwwwwwwwwwwwwwwwwwwwwwwww
