wwwwwwwwwwwwwwwwwwwwwwwwww
w....................xx..w
w.....x..............xx..w
w.x...x.......xxxx.......w
w.x...........xxxx.......w
w.x......................w
w.....................xx.w
w......A..............xx.w
w........................w
w........................w
w....xx...........e......w
w........................w
wwwwwwwwwwwwwwwwwwwwwwwwww
