wwwwwwwwwwwwwwwwwwwwwwwwww
wxx...................xx.w
w.....................xx.w
w....A.....xxxx..........w
w........................w
w........................w
w...............xx.......w
w..........x.............w
w..........x.............w
w.xxxx.....x..........e..w
w..........x......x......w
w.................xx.....w
wwwwwwwwwwwwwwwwwwwwwwwwww
