wwwwwwwwwwwwwwwwwwwwwwwwww
w.xxx....x........oo.....w
w.www....x.w...xx.oo.xw..w
w......A...w......oo.xw..w
wooooo.....wwoo..wxw.xw..w
wooooo.....oooo..wxw.xw..w
w...www.w...ww.x.w.......w
w......ww..xx..x.w.......w
w..xx...........ooo...x..w
w..xx..oo..w....wo.e..x..w
w.....ooo.ww...ww........w
w.........w....w.........w
wwwwwwwwwwwwwwwwwwwwwwwwww
