wwwwwwwwwwwwwwwwwwwwwwwwww
w..xxxxx...........xxx...w
wwwwwwwwwww........xxx...w
w.........w..............w
w....xx..........wwwwww..w
w........................w
w..xx.....ww...xxxx......w
w..x.......w.......e..oo.w
w..........w..........oo.w
w.......A..w....www...oo.w
wx..xx.....w...ww........w
w..........w.............w
wwwwwwwwwwwwwwwwwwwwwwwwww
