wwwwwwwwwwwwwwwwwwwwwwwwww
wxx..........w......oo...w
wxx.ooo....x.w.xx..A.oo..w
w...ooo.w..x.w.......ooo.w
w...o.wwww...w......wwww.w
w.x.ow.......oo.ww.......w
w.x..w......xoo..w.....x.w
w...ooo......o...o.w...x.w
w..w.ooowwwwww..xoo...w..w
w..w....o.xx......oo.wwxxw
w..w..xxooxx...e...oww.x.w
w........ooo........w....w
wwwwwwwwwwwwwwwwwwwwwwwwww
