wwwwwwwwwwwwwwwwwwwwwwwwww
w------------------------w
w----A--oo-----------oooow
w-------oo-x-----xx--oooow
w-o--------x-----xx------w
w-o-.---..-x--.----------w
w-o-.-xx..-x...--oo-xx---w
w-o..-xx......---oo-xx---w
w--.........xxx--oo------w
w............xxx---------w
w......x.........-----e--w
w...............---------w
wwwwwwwwwwwwwwwwwwwwwwwwww
