wwwwwwwwwwwwwwww
w___w_......3__w
w___._......_A_w
w_..._w.....3__w
w_w.3_w.....___w
w_.._3w__....3_w
w_....w__......w
w___..w__......w
w___w..3_......w
w___w..........w
w___...........w
w_..........___w
w_........_____w
w_........_ww__w
wg........__w__w
wwwwwwwwwwwwwwww
