wwwwwwwwwwwwwwww
w__111111111111w
w2w111111111111w
w2w111111111111w
w2w111111111111w
w2w111111111111w
w2w111111111111w
w2w111111111111w
w2w111111111111w
w2w111111111111w
w2w111111111111w
w1w130303030301w
w.w103030303031w
wgw130303030301w
w_w_0303030303Aw
wwwwwwwwwwwwwwww
