wwwwwwwwwwwwwwww
w_.311111111111w
w2w103030303031w
w2w111311111111w
w2w103030303031w
w2w111111111111w
w2w103030303031w
w2w111111111111w
w2w103030303031w
w2w111111111111w
w2w103030303031w
w1w111111111111w
w.w103030303031w
wgw111111111111w
w_w_0303030303Aw
wwwwwwwwwwwwwwww
