wwwwwwwwwwwwwwww
w_.____.____33_w
w___222____0___w
w_2__w_w___ww__w
w__2______.___2w
w____33_____w__w
w_w_w_3__w__w__w
w_1_w_g__ww_w__w
w___w__1__w_3__w
w__0ww_11_w_3_2w
w_____333_w____w
w_1__________2_w
w.11__www__3___w
w___2_____111__w
w_____1______A_w
wwwwwwwwwwwwwwww
