wwwwwwwwwwwwwwww
w...00...10....w
w..1__ww___1...w
w.1___w_____0.1w
w.___wwwww__...w
w0__wwwwwwwww..w
w.__wwwww.___..w
w.w_ww_______.3w
w._ww__g____w..w
w2__w_w___.ww..w
w1__wwwww......w
w._____0....2..w
w.1____0...__..w
w..3__w_______.w
w...2.._..3__A.w
wwwwwwwwwwwwwwww
