wwwwwwwwwwwwwwww
w_3_000022222_gw
w__003333333__3w
w__30___ww__w_3w
w____ww33__ww__w
w3wwwAw33__w_33w
w3w2w2ww__22__3_
w322w_32w2__w_3_
w330w_22_www__3w
w_22__2_____w__w
w_22_00__w3_ww_w
w__2_020__33w3_w
w__w_020021_23_w
w00000_2230__3_w
w___0_______3__w
wwwwwwwwwwwwwwww
