wwwwwwwwwwwwwwww
w_....__w._ww__w
ww....0_...._g_w
w_.w_.__...._3_w
w.w._.__.wwww_3w
w..w_0_..w...._w
w....._..w...._w
w....._......_.w
w___.w...w...__w
w_...w.ww...._.w
w_........1_...w
w0__..._..A___2w
w..._.__....___w
w..._._3__.....w
w..._______.w..w
wwwwwwwwwwwwwwww
