wwwwwwwwwwwwwwww
w____.___w_.___w
w_.0__0.2_.._._w
w_.__w_1__3.___w
w_.._0......2_.w
w_1_.0__._..__1w
w___...3_.w_.__w
w_0_.w..__._.w_w
w__._.__._3._._w
w__2__..__.._w.w
w1www.._A2_.___w
w._3..w__w_.._.w
w._....___...__w
w__0_3.2...._..w
w_0.__.._._.g__w
wwwwwwwwwwwwwwww
