wwwwwwwwwwwwwwww
w_____33333__wAw
w__0__133__1_w_w
w_3__112_2111w_w
w_3_1wwwwww__w_w
w_1_wg______w1_w
w11w222wwwwww1_w
w1_www___2ww___w
w1_w__2___2133_w
w__w_1333121333w
w__w33_3332_332w
w1__2333w1w33__w
w___33_w11121w_w
w__2333332www__w
w____1___1_3___w
wwwwwwwwwwwwwwww
