wwwwwwwwwwwwwwww
w__0__...___...w
w___________..1w
w_22.._.w____www
w__w..__wwwww__w
w..ww.1_w___w__w
w....w_ww__w_g_w
w___.._.._ww___w
w__0_._...w____w
w.1.wwwww.w..3_w
w..w._00_www.__w
w.________..w__w
w.1__ww0__.___ww
w__A__w_0_..ww_w
w2____000______w
wwwwwwwwwwwwwwww
