wwwwwwwwwwwwwwww
w___....3_w....w
w_1....ww.w.2__w
w0......w_.____w
w_......w2.A.__w
w_..w...w_...3_w
w_..w..ww_...__w
w...w..w......3w
w...w..w..__...w
w_..w....___.._w
w..ww...._.__._w
w._wwwwwww.__..w
w.._0.._._..___w
w_._..._._..___w
w___...3_3.._g_w
wwwwwwwwwwwwwwww
