wwwwwwwwwwwwwwww
w0..___....3___w
w_..___.3____._w
w_._._w.w10.w._w
w__......1..w.Aw
w__.w...w...w._w
w_2_w____3..w._w
w___w_2__3_.w.3w
w0__w...3.0....w
w..1w...w.ww...w
w...w....._....w
w_..w...___...gw
w.._......_..._.
w.0._..._0..000w
w.__....__.__.ww
wwwwwwwwwwwwww..
