wwwwwwwwwwwwwwww
w_....__w._ww__w
ww....._.._g__.w
w_.w.._..____._w
w.w......____..w
w..w....____...w
w..............w
w......__..w..2w
w____w___._0.3_w
w_...._w.....w.w
w_..w._..._A...w
w..ww._...1_...w
w.....__.......w
w..._.____.0...w
w..._____2_2w..w
wwwwwwwwwwwwwwww
