wwwwwwwwwwwwwwww
w.0w11_2___2w2_w
w___0___._.21w_w
wg.1__3.1._1..ww
w.1310_w_312.1.w
w.._1_13323_010w
w.0.13_023.3_1_w
w0001.0311_.130w
w_0_____0_.112.w
w23_2.21_...0w0w
w03.22.___0.012w
w03_.1_._11..1_w
w_.__w2_.2.23__w
w..20.12201220_w
w_.2._A1_____._w
wwwwwwwwwwwwwwww
