wwwwwwwwwwwwwwww
w0..._..333____w
w._..._...33_22w
w.....33_.__22_w
w...1_31..3.___w
w_...._._..____w
w..1.._1___0_.0w
w.1._...3_.....w
w_.11_.www...._w
w.w...._..www__.
w._.....1.A.ww_w
w.__.....1__.._w
w_._11....0gw__w
w____1_._._.w._w
w___._____2_.._w
wwwwwwwwwwwwwwww
