wwwwwwwwwwwwwwww
w0__31.1_1..___w
w3333_____.1___w
w3__.__1_A___2_w
ww3____1..1___3w
w1____2.2._..__w
w__._....220_.0w
w0___.2..__._..w
w_.___._.___w_.w
w.__...__._w_0..
w..33....www.w.w
w._....._ww_...w
w_..3._..0_w_.gw
w_.______ww._._w
w0............_w
wwwwwwwwwwwwwwww
