wwwwwwwwwwwwwwww
w3_____2____.__w
w3_....___..__.w
w33.w..____w__.w
w3__w..www__w..w
w__www.w_..w.w.w
w___.___g__ww__w
w_w.__www_www__w
w_w___w11______w
w_0.__w11_._w_2w
w_w__.w_______2w
wwww_ww__2_w_32w
w00_0_A_..._1__w
w______....__3_w
w_11_._0...w...w
wwwwwwwwwwwwwwww
