wwwwwwwwwwwwwwww
w0_202010_11133w
w210102_2320.32w
w21A3w3113003w3w
w21001322.01.21w
w332w1213011022w
w02321010311302w
w.012.031011322w
w.1.w102031w33.w
w10.1103330310ww
w0w30_0102.2001w
w023102.1031303w
w3111000100233.w
w22__211_2.333.w
w_.3.23w333010gw
wwwwwwwww0wwwwww
