wwwwwwwwwwwwwwww
w1A___0_..._1_3w
w._w.1....._.._w
w._w...........w
w._w...........w
w__ww..........w
w___.......____w
w1._0......____w
w..............w
w.__......w....w
w.__......w....w
w___.....ww....w
w___..wwww...2_w
w....ww.....___w
w0__.wg.....__3w
wwwwwwwwwwwwwwww
