wwwwwwwwwwwwwwww
w_...3__0A____1w
w__ww._00___._1w
w_0w.._w___w2..w
w11w_..__2ww2..w
w1_w._.__w____.w
w1w..33_ww.2___w
w____.2..._.3w_w
w0_...2..._._w_w
w_w..._____.3w_w
w....w3___w._w_w
w.._.w_..__._w_w
w....wwww_ww_w_w
w.._w._w.0.____w
w___g__w___._33w
wwwwwwwwwwwwwwww
