wwwwwwwwwwwwwwww
w____003333____w
w__0__011111___w
w_30000___11w__w
w_30_____w11_w0w
w_1_3_3____1_w0w
w11___2w_ww1_w0w
w1_A_00______w0w
w1____200001w30w
w____wwwwwwww30w
w__ww3_33_2_330w
w3_____3w1__3_0w
w3__133w11ww100w
w_313133__wg333w
w__331__3_ww___w
wwwwwwwwwwwwwwww
