wwwwwwwwwwwwwwww
w___......w....w
w_.....w..w...3w
w0......._...3_w
ww...ww2.....__w
w_g_____0....3_w
w......www.....w
w..............w
w..............w
w_.....320...._w
w_w2...___..3w_w
w_w_..._._.._w1w
w1w_..._._..Aw_w
w_._..._._.._._w
w___...3_3..__3w
wwwwwwwwwwwwwwww
