wwwwwwwwwwwwwwww
w___...__1__...w
w_w__..3____.._w
w_w__..w____...w
w.wg__ww___....w
w2ww.ww____....w
w_...__.0___...w
w_._....___....w
w____3_._..__..w
w___A__...__.._w
w_______.__..._w
w_00....__._.__w
w_30_0___000.1_w
ww______000011_w
w._.__1_000_.__w
wwwwwwwwwwwwwwww
