wwwwwwwwwwwwwwww
w2_2_w__0_333__w
w_..___0__3.3_ww
w_..__w_w_w___.w
w_0.....__w_...w
w_0....___w___.w
w_A....___w___.w
w11.....__w_._.w
wwwwwwwwww__._.w
w....___w__w__.w
w_..._1_g_w_.__w
ww...11__3w0_.2w
w_wwwww_wwww__2w
w______33w0__.2w
w__wwwww3w0_..2w
wwwwwwwwwwwwwwww
