wwwwwwwwwwwwwwww
wA___0_...____gw
w_____0..1www__w
w__10.......1w_w
w............w_w
w........3...w_w
w............w_w
w1...........w_w
w____0.........w
w.____.1__0__..w
w.____.._0___..w
w.ww__..___ww..w
w...__1.w_ww...w
w0.3__0.www....w
w...2_0..ww....w
wwwwwwwwwwwwwwww
