wwwwwwwwwwwwwwww
w32_3_33333__0_w
w__w_3__0_33__1w
w_3____0ww__20_w
ww_wwwww__2w_01w
ww__2__2_____2_w
w_0w_20__20_w_2w
w0_w_20_w___111w
w_0_ww0___0w___w
w11_ww__1____w_w
w___1__1__w_w_2w
w_2__w__www___2w
w_1ww__0___w_w_w
w2___w__11_w_w_w
w____Aw_0__w2g2w
wwwwwwwwwwwwwwww
