wwwwwwwwwwwwwwww
w0g___w_...._w1w
w....w_.....__3w
w....w_........w
w....w_........w
w.wwww_.....3_.w
w...ww_....2A2_w
w...ww1..._wwwww
w0...w...._....w
w__.ww...._._..w
w12_w....._..._w
w...ww.1.._.._.w
w........._..._w
w__...3_0._..._w
w_2...w____.._3w
wwwwwwwwwwwwwwww
