wwwwwwwwwwwwwwww
w_.._..__.__.._w
w_...3_.2...2._w
w_0_1.__...22._w
w.._..0._._..1_w
w..2.1_....0_._w
w_.....3_..0__3w
w_2.0_._1._1...w
w_0.._.._w_..2.w
w._1.._0_....2_w
w.__..._._0.2__w
w.0._g___._..__w
w_...0.3w.._.0_w
w___1___302..__w
w2._._A__._._._w
wwwwwwwwwwwwwwww
