wwwwwwwwwwwwwwww
w__222_____33__w
w__33_22__11_3_w
w_3ww__w11www3_w
w__wwwwww0_0w3_w
w__111ww_w__13_w
w_w___2__1__1g_w
w_w_100__w___3_w
w___0_111_w_33_w
w2__w11_3__w3__w
w2_w11___1_w_3_w
w22__w_www_w__3w
w_2233_____ww__w
w___22_0000____w
w_A__22________w
wwwwwwwwwwwwwwww
