wwwwwwwwwwwwwwww
w._._..0......0w
w____0_..__..__w
w__0_.__._w_.._w
ww__2__.2w__.__w
w_____w._._.___w
w_0_._...._..__w
w__.__..__.___.w
w____2...._..3_w
w_0_......_.___w
w__.....____3__w
w0.1........__3w
w..21..2.w_.___w
w1___1_A_wg____w
w____.___w__3__w
wwwwwwwwwwwwwwww
