wwwwwwwwwwwwwwww
w______._______w
w__.___00_1____w
w__.3w_0__...__w
w_._.w_______._w
w_.__w__..___..w
w_2__w2.____0__w
w_2_gw_00_ww___w
w_2._ww___w____w
w__3__3_ww__ww_w
w_3__3__.__w_w_w
w__ww___._.____w
w3_2_www_._1_w_w
w__21__1__1_w__w
w__2_A___1_____w
wwwwwwwwwwwwwwww
