wwwwwwwwwwwwwwww
w_._..2..1__0._w
w_....2..___w__w
w0ww__w_____ww_w
w.w__._____1_w_w
w.w______wwwww_w
w1_g_.....33.2_w
w_w_wwwww.___2_w
w_w____.___22__w
w_w.00__.___w__w
w____0..__Aw___w
w_ww__.www__w0_w
w__._0.w..1_w00w
w__.._.w...w.0_w
ww__.w_w_____0.w
wwwwwwwwwwwwwwww
