wwwwwwwwwwwwwwww
w____....____._w
w_..______1____w
w_2_3ww________w
w.._..____w__2_w
w_.__.._..._A_2w
w_._3_2.__w____w
w__w.__.__w_w__w
w__.w.30_______w
w___ww3...._w_.w
w__w_3____0.___w
w____3_..w_.___w
w_g_______1____w
w___1_3111.__3_w
w_._________0__w
wwwwwwwwwwwwwwww
