wwwwwwwwwwwwwwww
w____1.....wwwww
w____0.......www
w.___0..1______w
w.........120..w
w..............w
w..2.........12w
w1____...______w
w_____..0______w
w__............w
w__.....3w.....w
w......3_w_....w
w......__w_....w
w......3_w_w...w
w......_Awgw...w
wwwwwwwwwwwwwwww
