wwwwwwwwwwwwwwww
w_0___0__0___0_w
w00_22___3333__w
w_22w32200023_0w
w_2__w022w333__w
w_200000023_33_w
w_1w00www_11w3__
w1_2_0w___21_3__
w1_2_0w_w__1w3_w
w1w222022221131w
w12wg_w3322w131w
w12w_333ww__13_w
w_122ww__w331__w
w3_1111111111__w
w__w______111A2w
wwwwwwwwwwwwwwww
