wwwwwwwwwwwwwwww
w3A23212_22121gw
w20022_21222w22w
w32002w2_222332w
w20_02222212322w
w_10021__222232w
w020_3ww_2_w230w
w13w32____33w30w
w_33____w__1_30w
w0303_w_w__3330w
w300_w22_123_03w
w01011___113_w1w
w11011_w133w133w
w1w0011112_1333w
w_00__2_233233_w
wwwwwwwwwwwwwwww
