wwwwwwwwwwwwwwww
wA____________1w
w____21101_____w
w..............w
w..wwwwwwwww.3.w
w.0__w___w__.__w
w..__w_g_w3_.__w
ww.__w___w2_.__w
ww.__w___.__.__w
ww.__w___.3_.__w
w..__w....__.__w
w.._________.__w
w..___310___.__w
w22..........__w
w______________w
wwwwwwwwwwwwwwww
