wwwwwwwwwwwwwwww
wwwwwg_ww.1.3..w
w.www__w__.....w
w.w..2.3___w...w
w.ww....__ww2..w
w1...w...ww__..w
w_3..ww....___.w
w__...w.w..___.w
w___2...ww..___w
w.___....ww.._3w
w.1___....w..2.w
w..____1.......w
w..1_____0.2ww.w
w...0____0_..w.w
w...2_____A_..ww
wwwwwwwwwwwwwwww
