wwwwwwwwwwwwwwww
w______._______w
w__3___00_1____w
w_w33_30_ww_.0_w
w_w__w____w__0_w
w_.3_wA_3._w01.w
w_w3_w__3______w
w_wwwww0__w1w__w
w_0.3_____ww___w
w__311111w_1_w_w
w_3_g_3_1w.._._w
w__w.201_w_3_3_w
w3_2__200w_03w_w
w1_.._122_1_3__w
w___.____1w_3__w
wwwwwwwwwwwwwwww
