wwwwwwwwwwwwwwww
w0_3_1.__1.31__w
w_A13.___1_____w
w__1.._00__1___w
ww0_.0_0_.30___w
w_.._00.00_30_1w
w....0..0__0__0w
w.._.00._333__.w
w._..w330w_30_.w
w..033..____.0_.
w..033_33_.0_0.w
w0.0.220_......w
w_._.__0.0_._..w
w_.._1___0.....w
w___3__g___2.._w
wwwwwwwwwwwwwwww
