wwwwwwwwwwwwwwww
w0_._1.__1.31__w
w___..___1____gw
w__..._00__1_0_w
ww._.._0_.3_.__w
w_.._.......0_1w
w.......1...___w
w.._...........w
w._..ww.1w..._.w
w...w...1___.__.
w..............w
w.._.2200......w
w_._.__0.0_._..w
w_.._1___0.....w
w___2__A___2.._w
wwwwwwwwwwwwwwww
