wwwwwwwwwwwwwwww
wA....1_______.w
w_.....__...___w
w0..w.._ww..1..w
w...w._0_www...w
w...w.__.......w
w.www._3_.ww.__w
w__..._0....._.w
w____...____3__w
w.......ww____.w
w.....__.w.....w
w_....__.w.....w
w_..ww_gw....__w
w..._.ww.......w
w..._..........w
wwwwwwwwwwwwwwww
