wwwwwwwwwwwwwwww
w______.___11._w
w_g33__0_____1_w
w___www_w__0___w
w__wwA___ww33w_w
w_2__..._._w__3w
w_w___.3____00_w
w__w__2_0_ww_1.w
w___w______ww__w
w___ww__2__w___w
w____w_____w_w3w
w_1__w___w__ww1w
w___3_w____3___w
w_100_0_0___00_w
w___0.00__w____w
wwwwwwwwwwwwwwww
