wwwwwwwwwwwwwwww
w..w.___g......w
w........_.....w
ww........0.w..w
www.w..w....w11w
w.ww....2......w
w0w....__1..w..w
w__._w___....._w
w0.._w___....._w
w..._w_w__.w...w
w..____w_...._2w
w0._..........3w
w_..._.._._._w_.
w._..._....ww_Aw
w_1_.....0.__3ww
wwwwwwwwwwwwww..
