wwwwwwwwwwwwwwww
w______________w
w__wwww._w_._www
w__w0_.._w_w_wgw
w._w_..._w.__w1w
w._w_.._w_.._w_w
w._w_.__0_._ww__
w_.w__3w23..ww3w
w__w__w0_...w13w
w_____w_..._w_3w
w_____w_wwwww_3w
w______11______w
w__w_020_0__w__w
ww_A_____1_1w__w
w.._0___1__1___w
wwwwwwwwwwwwwwww
