wwwwwwwwwwwwwwww
w__g._1.w.www__w
ww.w..._..ww__.w
w_2w.._..www_._w
w__w....._ww_..w
w__.....___3...w
w..............w
w......__..w...w
w____w___._....w
w_..w._w_.w..w.w
w_..w.___.w....w
wwwww.w.._w....w
w0_.......w....w
wA....2___.0...w
w0.._____2__w..w
wwwwwwwwwwwwwwww
