wwwwwwwwwwwwwwww
w______._______w
w______00_1____w
w_A33_30www_.__w
w__3.w_w3_ww_._w
w_.3_w__.._w_1.w
w__3_w2.____0__w
w___2__00_w11__w
w_0.2w_____1___w
w__3_.3_ww_1ww_w
w_30_.__._...._w
w__w.20________w
w3_2_w200.00_w_w
w______22_1_w__w
w__2_____1g____w
wwwwwwwwwwwwwwww
