wwwwwwwwwwwwwwww
w.__________w__w
w___3_ww_0___w_w
w__33___11____ww
w_3__ww______www
w3___w_0____ww_w
w_w3__0_00w__0_w
w_ww_0_ww__w_._w
w0w._w_w_1_____w
w_0001___1___2_w
w_w_____2_ww___w
w_____w__22ww_gw
wA1_3w__2__.w__w
w_______222.wwww
w1_w_______...ww
wwwwwwwwwwwwwwww
