wwwwwwwwwwwwwwww
w..............w
w.__2________..w
w.________3___.w
w._____333____.w
w._w_33___g1__.w
w.__3_________.w
w222____1___0_.w
w.w__2_0____0_.w
w.___2221111_0.w
w.___11222____.w
w.__11___22___.w
w._11___A_____.w
w.____________.w
w..............w
wwwwwwwwwwwwwwww
