wwwwwwwwwwwwwwww
w....__.__..___w
w.._______..w_.w
w..__.w___..wg.w
w_w_..ww__.1w..w
w....__ww1__w..w
w2__________w..w
w___w2w_____w1ww
www......._____w
w_w......w_____w
w_w_...____..__w
w_..ww.www...__w
w..2.w.3__0..._w
w_w_...3_0.._2.w
w__A_____._____w
wwwwwwwwwwwwwwww
