wwwwwwwwwwwwwwww
w0_._1.__1.31__w
w___..___1____gw
w__..._00__100_w
ww._.0_0_.300_0w
w_.._00.00.00_1w
w....0..00.0__0w
w.._.00....0...w
w._..ww.0w..00.w
w..0w...0___.0_.
w..0..000..0.0.w
w0.0.2200......w
w_._.0_0.0_._..w
w_.._1___0.....w
w___2__A___2.._w
wwwwwwwwwwwwwwww
