wwwwwwwwwwwwwwww
w___..__A_...3_w
w___..____...__w
w....._2__...__w
w.ww..3_0_...._w
w__ww._1__....1w
w1___..........w
w.1_2..3...2___w
w......ww..3_www
w..............w
w......wwww....w
w2_....wg_ww...w
w__....w___www.w
w___0..ww___ww.w
w____0....__ww.w
wwwwwwwwwwwwwwww
