wwwwwwwwwwwwwwww
w012.0010_12123w
w110221_2233.32w
w2312w13.32w2w32
w210.1322.20.2.w
w331w133..2w.22w
w02w2.0333.w.32w
w.3.2.0112.13222
w.1.w13.031w33.w
w10.0103331w10ww
w.w3wA2001.2103w
w02302w.1031303w
w3.110000w0230.w
w22.3111g0.211.w
w_.1.22w333_10.w
wwwwwwwwwwwwwwww
