wwwwwwwwwwwwwwww
wA____0..______w
w______..01____w
w............1_w
w_____....3...3w
w_____0........w
w__1...........w
w1.............w
w...........wwww
w__...__2_0.w__w
w__3.._____.w__w
w_0..._____.w__w
w_2...__1_0.w__w
w_1...____..w__w
w_0...__....._gw
wwwwwwwwwwwwwwww
