wwwwwwwwwwwwwwww
w._._..0......3w
w____0_..__..__w
w____.__._w__A_w
ww____.._w_____w
w_.__.w..._3___w
w_3_......3..__w
w_w.__......__.w
w._____..___.__w
w.w___ww___.__0w
w_w.ww__w__w.01w
w_..w__.w__30_1w
w_..ww__ww____2w
w_...__www_____w
w_._____3._g___w
wwwwwwwwwwwwwwww
