wwwwwwwwwwwwwwww
w_.._w______.._w
w_.w.._w..1____w
wg1_0._2_w_w2__w
w___w..1_._w.2_w
w..__w0..2_.0._w
w_2.._.._.____.w
w__w_.10.w__ww.w
w_w_2__..__._..w
w.__..w_30._w__w
w22_____.______w
w_w.3._Aww1.w02w
w_._.w......._.w
w_30._w_.._w._1w
w_._._._3._._._w
wwwwwwwwwwwwwwww
