wwwwwwwwwwwwwwww
w__03_...___0__w
w__wwA____w____w
w_w..._.__ww_1.w
w0_..1111....._w
w..........._._w
w....w..w....._w
w___......w..._w
w__0_.w.ww...._w
w_...ww......._w
w_..w......____w
w_....____..___w
w_............2w
w_..g_...3__.._w
w.w0____..3_3__w
wwwwwwwwwwwwwwww
