wwwwwwwwwwwwwwww
w.2...11331____w
w.....1._3231..w
w.3211200.w211.w
w.301.3w2.22113w
w.3w1.1__2_2w.3w
w.0.13_120_03_.w
w02w11031220231w
w.0..22A33.00w1w
w23w.w1133.3.01w
w03.01.1.00_..2w
w.3_.333ww02.02w
w02w.w033w3330.w
w2.000ww3wg.202w
w222.0..3.w23__w
wwwwwwwwwwwwwwww
