wwwwwwwwwwwwwwww
w....0_1......_w
w_1...........3w
w..............w
w..............w
w.....1........w
w....3A0.......w
w.....2........w
w............w.w
w.g.........2_3w
w............0.w
w..............w
w..............w
w..............w
w._0.3_0.....2_w
wwwwwwwwwwwwwwww
