wwwwwwwwwwwwwwww
wg_.........__3w
w__.....1______w
ww__.wwww___._.w
w.wwww...w___0.w
w..w__.___.....w
w...1__A_0.....w
w....w____.....w
w.3___w1_w.....w
w2_____.ww22...w
w2____...___2..w
w2___0..w____..w
w__0......____1w
w__2......1___.w
w___3.......___w
wwwwwwwwwwwwwwww
