wwwwwwwwwwwwwwww
wg_w_.....__..3w
w__w_.....1____w
ww___........1_w
w.___........._w
w..__......0.._w
w.........._...w
w.........__...w
w.........__...w
w2.......2__...w
w_1..0.1.___0..w
w__......___0..w
w__0.....___3..w
w____2...___w..w
wA____w_____w..w
wwwwwwwwwwwwwwww
