wwwwwwwwwwwwwwww
w___...____2_2.w
w0w_______.....w
w0w__.ww__.._11w
w0____ww_00.11_w
w2_wwww_000_11_w
w__w__..____.._w
w___w.____w__._w
w.__w_..._ww_._w
w_g__w...__w___w
w____w...___A__w
w._._wwww_w____w
w....3333_____ww
w....____w_w._.w
w1222__________w
wwwwwwwwwwwwwwww
