wwwwwwwwwwwwwwww
w.._1111_ww___.w
w.._.____ww_3._w
w.._.._w.w__wwww
w_...._.w_www.ww
w._.....w__.___w
w....._.__w..w.w
w3_..._...._.w.w
w.___..__w_..._w
w......_..._..2w
w._.._.._w_A_.2w
w.______0__02__w
w.g____ww.__0__w
w._www_w2_030__w
w.______0__0___w
wwwwwwwwwwwwwwww
