wwwwwwwwwwwwwwww
w_1_._..__3_.._w
w_1_.._.____...w
w____._3_._..._w
w.____3_......_w
w___.._....__._w
w__._._...___._w
w0..___..___.._w
w_...A_.._g__._w
w...__...._____.
w...___..___.._w
w._.__.........w
w___0_0._...__1w
w____..._____w.w
w___._0.__2.___w
wwwwwwwwwwwwwwww
