wwwwwwwwwwwwwwww
w_____w_w..3___w
w.1...w.w...___w
w.....w.w..1_..w
w............2.w
w___2.......__.w
w___......2___3w
w..0.......w___w
ww_www.........w
w.__...........w
w.__...........w
wg__...........w
w___..w.......3w
w.w...w_w...2__w
w.w...w_w....A_w
wwwwwwwwwwwwwwww
