wwwwwwwwwwwwwwww
w222ww__0_g____w
w222ww_0__...._w
w_0_ww_w_..w2..w
w__www___..w_..w
w__w.___...w_..w
w1_w.w__wwww___w
w__w..www__.3w_w
w..w..w.w__.___w
w..w..w_w__.0__w
w__...w____._w_w
w....._0w__._w_w
w....._ww__w_w2w
w33____w.0._..1w
w33_A__w___..33w
wwwwwwwwwwwwwwww
