wwwwwwwwwwwwwwww
w____......3___w
w__0....wwww___w
w__..........1_w
w__....__0...._w
w1....____...._w
w....__A__....1w
w...._310......w
w..............w
w0..1..........w
w..............w
w.....www......w
w..w..___......w
w..w______2....w
w..w___g__2...3w
wwwwwwwwwwwwwwww
