wwwwwwwwwwwwwwww
w.A_.__.w_.....w
w___0._____._w.w
w__._......._www
w_1....ww____..w
w_.._.w_.__._1.w
w.____w...1.._ww
w.___w..._.___ww
w._.w...__.www_w
w._.1.__._ww___w
w__0_____w.wg_.w
w____w_._ww___.w
w_w..w..w._____w
w_.0____..2_.._w
w..___2..__w...w
wwwwwwwwwwwwwwww
