wwwwwwwwwwwwwwww
w______....3__Aw
w__........2___w
w_1.....0..1..1w
w_...____ww_...w
w_..____www_...w
w0..__www___0.1w
w..w__www___w..w
w..w_wwww__ww..w
w..wwwww__ww..ww
w...3_____3..._w
w....1___0...._w
www..........._w
ww__.........__w
wg__....3______w
wwwwwwwwwwwwwwww
