wwwwwwwwwwwwwwww
w______._____._w
w______0__1____w
w__3333_____g__w
w____w____w33__w
w_23_3__3____33w
w_______3______w
w_w_www0w_w1ww.w
w__________w_w.w
w__311111__1_w.w
w_3_._w_1w_ww__w
w_1_.wwwwww____w
w_.1._2_A____2.w
w__.1.1.2_1_.2_w
w________1w_3_2w
wwwwwwwwwwwwwwww
