wwwwwwwwwwwwwwww
w..._......3___w
w..._____..w___w
w...A_ww_..ww__w
w...._w....ww._w
w_...3_...ww.1_w
w_.......ww....w
w____..........w
w.1....____....w
w..._..w_g_..3.w
w...__0w___..w.w
w..____ww__....w
w_.0___.www....w
w______.......2w
w____0......2__w
wwwwwwwwwwwwwwww
