wwwwwwwwwwwwwwww
w2_21w_10_3.._1w
w_._......._3__w
w__A_..w__w___ww
w____.w.__w_..ww
w3w_..w________w
w3w_._w___w__w.w
w3w.._.._.__ww.w
w_.___w...__.._w
w__.._w_.._w.._w
w_w..ww...w_.._w
wwww..w.._w0_._w
w.....w...ww__2w
w....0.___0_2._w
w..___wg______1w
wwwwwwwwwwwwwwww
