wwwwwwwwwwwwwwww
w0____1.....___w
w___1.......___w
w__...0........w
w__.......__2_gw
w.2........3w__w
w..______1..w__w
w..______1..w__w
w..wwwww_0...__w
w.......__...__w
w..............w
wA_2___w.3_2__2w
w_____0ww______w
w...._0..__wwwww
w...._0ww__w...w
wwwwwwwwwwwwwwww
