wwwwwwwwwwwwwwww
w3__________.__w
w__._._22_..___w
w___w_.22__w__gw
ww_w___22w__w__w
w__wwwwwww_w___w
w_ww...11_www__w
w_w....11wwww__w
w_w....._w_____w
w_w...wwww._w3_w
w_w_______3333_w
wwww__w____w3_.w
w0__0___._._..ww
wA____w____...ww
w_____ww.___..ww
wwwwwwwwwwwwwwww
