wwwwwwwwwwwwwwww
w.0w110w_w1ww2_w
ww..0w_...w._w_w
w3.2g__11._w..ww
w3w3003w_312...w
w..w1.1332322w.w
ww0.13_023_33__w
w0.w1.03121.13_w
w_______011.32.w
w_322311_.21_w0w
w03.03.___0.2w2w
w03_.1_._11w.._w
w_.11w2_1w11.__w
wA_2231w31w1w0ww
w.2_w02__.w23..w
wwwwwwwwwwwwwwww
