wwwwwwwwwwwwwwww
w__..........1.w
w_..0_____3.___w
w1.w.__.__ww___w
w..w.A..__.1___w
w_.wwwwww___w._w
w.w_g_.3_...w..w
w.w.........w..w
w.w............w
w_w.wwww_______w
w___w_.__w___w_w
w__.w_..2w.._w_w
w_.....ww....._w
w_.....w..._2..w
w0__.......__.2w
wwwwwwwwwwwwwwww
