wwwwwwwwwwwwwwww
wwwwwg___......w
w.www_____.....w
w.w.....___w...w
w.ww....__ww...w
w1...w...ww__..w
w_3..ww1...___3w
w__...w.w..___.w
w___2...ww..___w
w.___..2.ww.._3w
w.1___....w..2.w
w..____........w
w..1_____0.2ww.w
w...0____0_..w.w
w...2_____A_..ww
wwwwwwwwwwwwwwww
