wwwwwwwwwwwwwwww
w01..____...___w
w__..........3_w
w.g.www.......1w
w.....0.....1w.w
w..w..__._.__w.w
w...___...._...w
w...__...__..w.w
w......ww_..__.w
w.____2_Aww____w
w..ww..__0_.__.w
w.w..1__w_.w._.w
w.._____....._.w
w20.._._....._.w
w__0._2_2...3__w
wwwwwwwwwwwwwwww
