wwwwwwwwwwwwwwww
w.___________10w
w_100wwww.ww01_w
w__0w..03__2w__w
w0_3w111_..31_1w
w1__w_1..2._3_0w
w1w1ww_3033w___w
w_w__w31.._.w20w
w_w__w_.0__.._2w
w_w_2_w1_13w__0w
w_.w___w___w._2w
w..w._2.www___3w
w.._w__03_g3_23w
w..._w_w_0..33_w
w....A_2_ww__2_w
wwwwwwwwwwwwwwww
