wwwwwwwwwwwwwwww
w__...w1.3__A..w
w__0......___.1w
w_....w...._0..w
w..........1_w_w
w............w_w
w2..3_........_w
w....___......gw
w....w1___....ww
w......w___....w
w......ww......w
w..............w
w.133..........w
w_____.........w
w____.3....0...w
wwwwwwwwwwwwwwww
