wwwwwwwwwwwwwwww
w_A________00__w
w____w________0w
w_________1____w
w___2__3w00____w
w__122_30__100_w
w___312022______
w___300_11_1___w
w___00_0__1__2_w
w_10____3w1__2_w
w_1_3w_w_31__2_w
w____32___1____w
w__2__1w_w122__w
w_11___33_wwwwww
w____________g_w
wwwwwwwwwwwwwwww
