wwwwwwwwwwwwwwww
w_____.___.___Aw
w_33________w__w
w__333_0_____www
w___ww3__w_w_w_w
w____1w3___w_22w
w_w2_1__31_w__2_
w______w3_1w__2w
w__w_2_w3______w
w__w__2_____w__w
w_ww1_2_w31_w__w
w__w__2_w_3__w_w
w_1www__ww1w0w_w
w_00_0_031__...w
wg_______1__...w
wwwwwwwwwwwwwwww
