wwwwwwwwwwwwwwww
wA__0..__w_.___w
w_.___3____._._w
w____ww.__3._.1w
w___2...__...w.w
w2_0...3._.._w.w
w___....__w_.w_w
w_._.w..1w._.w_w
w____..._w.._._w
w2w._0..__.._w.w
w.www..1.._.2._w
w.....w__w_..._w
w._....___...._w
w_1__3......_._w
w___2.._.._.g__w
wwwwwwwwwwwwwwww
