wwwwwwwwwwwwwwww
w_____________gw
w_...____wwww__w
w_..___..__..._w
w0........_____w
w_1.__.....____w
w__.___....__..w
w__wwww_...__..w
w_______ww___..w
w____..2.w___..w
w0___..._1..._.w
w__www0____..__w
w_...w...._.2__w
w_...ww.2.2____w
w_..._A_____3__w
wwwwwwwwwwwwwwww
