wwwwwwwwwwwwwwww
w___1........3_w
w.1..____.....Aw
w...._ww_......w
w__.._www......w
w_...___w....1_w
w_.....www.....w
w____..ww_.....w
w.......w__....w
w...0...w__ww..w
w...w...g___0..w
w...w...___....w
w_..www........w
w___0....___w..w
w____....23____w
wwwwwwwwwwwwwwww
