wwwwwwwwwwwwwwww
w...0__...w___gw
ww...__.....___w
w_...__........w
w___2ww........w
w.0___.........w
w.......__w2...w
w.......__w_..3w
w..............w
w.....www......w
w22.........._2w
w__..........__w
w__..3_2_0...__w
w__...___...___w
w__..._A_...___w
wwwwwwwwwwwwwwww
