wwwwwwwwwwwwwwww
w__________33__w
w__33__1__11_3_w
w33g_w_w111_13_w
w3___w_110_0_3_w
w3_11wwwww__13_w
w3___12__1w_13_w
w_1_1001_0w_13_w
w3__0_033_w_13_w
w_3_w1333_w0___w
w__w_____1w__w_w
w_wA_wwwww_3__ww
w_ww33____33ww_w
w__w333333_1w__w
w_________3____w
wwwwwwwwwwwwwwww
