wwwwwwwwwwwwwwww
w............__w
w.__2__________w
w._g______333__w
w._00____3_13__w
w._003__0_11___w
w._00000_______w
w2______13__0__w
w.___2_11_3_0__w
w._333_11_____.w
w._3_332___22_.w
w.__1122__2_2_.w
w._11_________.w
w._______A____.w
w._...______...w
wwwwwwwwwwwwwwww
