wwwwwwwwwwwwwwww
w_______...3___w
w___..www..3___w
w1_0.....1...__w
w............._w
w.w........0.._w
w....wgw_3.....w
w....w_._w.....w
www..w_._w...w.w
w....w___w...w.w
w....wwww......w
w..............w
w22_.......2..3w
w__1.......____w
w___.......3__Aw
wwwwwwwwwwwwwwww
