wwwwwwwwwwwwwwww
w__03...._..__gw
w__wwwwww_..__ww
w_w..._.wwww__ww
w0_..._....._w_w
w......_...._._w
w....w.ww....._w
w.._......_..._w
w2.0......_..._w
w_._......w..._w
w____0.....1..1w
w__wwww.ww_1..3w
w_w__....._..2_w
w_..__...3_____w
w.w0____..3_A__w
wwwwwwwwwwwwwwww
