wwwwwwwwwwwwwwww
w____.0.._____gw
w__ww......____w
w_ww...........w
w_....2.....3www
w..0........_www
w.._wwww...ww__w
w..____w...ww_1w
w..........ww_.w
w..........ww..w
wwww...........w
w_ww...........w
w_ww..231......w
w__ww.____.....w
w___..3_A_0..2.w
wwwwwwwwwwwwwwww
