wwwwwwwwwwwwwwww
w2_2_w__0_333__w
w_..A__0__3.3_ww
w_..._wwwww1__.w
w_00_.____w....w
w_00__w_w....2.w
w_ww3333ww.._..w
w_w..___w_.....w
www..__.__.....w
www..___w_.....w
www__wwww_...__w
www_1w___..0_._w
www__ww____w___w
w_w____3300__._w
w__g___3300_.._w
wwwwwwwwwwwwwwww
