wwwwwwwwwwwwwwww
w3_____________w
w__...__...____w
w_0........__g_w
w_0........____w
w_w.........w__w
w_w.........ww_w
w.w........._w1w
w2w.....w..__w1w
w_w_........w11w
w___333_w..ww11w
w_w_w___...._11w
w_w_0w2.w.._.11w
w_Awww00w....11w
w__..__...ww.__w
wwwwwwwwwwwwwwww
