wwwwwwwwwwwwwwww
w..1A1..w......w
w.......wwww...w
w.......g_...__w
w........___1w1w
w..........___.w
w..........__2.w
w..........__.ww
ww........____ww
w0........__3_2w
w_........____.w
w_.......__....w
w_...._......._w
w.0_.._.____..1w
w2__.._.3_0__0_w
wwwwwwwwwwwwwwww
