wwwwwwwwwwwwwwww
w_2_____22_____w
w_2_2ww_2_____0w
w_22_wg_2_1____w
w____w_3ww_____w
w_ww_ww___w10__w
w_w______2w____w
w___3___1_w_3__w
w_w__0_0__w_1__w
w__w____www_13_w
w__w3___1311_3_w
w__w___1_____3_w
w0__wwwwwwww___w
w_00___33__wA__w
w______________w
wwwwwwwwwwwwwwww
