wwwwwwwwwwwwwwww
w_____1w___wwwww
w3w311w___220__w
w3w00_3033__1w_w
wgww333ww_2133_w
w110332www11_w_w
ww01_23__w0w0wAw
w1w032w0w3_210ww
w3__30003w0320_w
w3w3w3_0ww313www
ww231w332w_w22_w
w_1_0001ww1_0w_w
w_2w332300__031w
w_____32___31w1w
ww22ww___w01wwww
wwwwwwwwwwwwwwww
