wwwwwwwwwwwwwwww
wA________..___w
wwwww_____..___w
w..ww_____.....w
w...w__2__.....w
w...._3_0_..2..w
w....__1__.....w
w...._____.....w
w..............w
w____..3.......w
w21__......w__gw
w__0.......ww__w
w..........ww__w
w...._3_...ww__w
w_____0_......_w
wwwwwwwwwwwwwwww
