wwwwwwwwwwwwwwww
wA_2_______..__w
w2________...__w
w____ww_2_...__w
w__www_______w_w
w________3__ww_w
w____2___3_____w
w_0____w__00___w
w_0___w____3___w
w____w_333___w_w
w____w____w__w_w
w____w_1_______w
w_...__1___0__3w
w....__1_000_3_w
w...___1_____g_w
wwwwwwwwwwwwwwww
