wwwwwwwwwwwwwwww
w__________....w
w_.ww____ww....w
w_w._ww_.__2...w
w_w...ww..____Aw
wg_.__.www.____w
w_..___....__1.w
w...www_..3___.w
w...____ww___..w
w..._.._.w___..w
w..._.____..._.w
w...ww_____..__w
w__..w...______w
w__..ww2___...0w
w__________3...w
wwwwwwwwwwwwwwww
