wwwwwwwwwwwwwwww
w___0..........w
wA___1w........w
w...w.w........w
w2..w.....wwwwww
w_........w.___w
w_._.._...ww...w
wwwww__....w...w
w_...__3.......w
w_..w_ww.......w
wg.ww..__.w_1..w
w_.....__.3__0.w
wwwww.....w._3.w
w_..w.....ww_www
w0____.....____w
wwwwwwwwwwwwwwww
