wwwwwwwwwwwwwwww
w______________w
w___________33_w
w_1_0333__12_3_w
w___111__0_1___w
w_1_11_2_333___w
w_1__ww_30_3__3w
w_2_w3w3w__3_33w
w_2w_030_w3__3_w
w__w0_3_0___w__w
w_w0_23_30_ww1_w
w____22__w__3__w
w_w___03ww_22__w
w_0w3_3_ww_1___w
w__w____gw____Aw
wwwwwwwwwwwwwwww
