wwwwwwwwwwwwwwww
w.......__..___w
w.03w__..2....3w
w_.0.__._.....3w
w_1_1_1._113.._w
w_....._0.2..._w
w_.._1302__.23.w
w.1._.0..._._..w
w_0......___..2w
w_....ww.1___..w
w3.__3.w.2.w0._w
w_..__0.._.2.._w
w_..w....._..._w
w________.._.__w
w......A02_..g.w
wwwwwwwwwwwwwwww
