wwwwwwwwwwwwwwww
wA________.1__1w
w...._____..___w
w...._____...._w
w....__2__.....w
w...._3_0_...2.w
w....__1__.....w
w...._____.....w
w1............_w
w_............_w
w_.....3......_w
w_...ww......0_w
w_..www__www.3_w
w_2ww______ww2_w
w__w___g____.3_w
wwwwwwwwwwwwwwww
