wwwwwwwwwwwwwwww
w_....__w._w___w
ww.........._3_w
w_..w.......___w
w...w..___...__w
w...w.2ww0..._0w
w.www._.wwww.__w
w._...A......_.w
w____w.......__w
w....w.ww0..1_.w
w........_.....w
w____.._._.....w
w__._.__....__3w
w22._......._..w
w...g....0_.w..w
wwwwwwwwwwwwwwww
