wwwwwwwwwwwwwwww
w__0.....1.___gw
w_wwww......w__w
w__...3.www..www
w_0._______2...w
w_..____.....32w
w1..www.2....__w
w.....w._....__w
w.2...w__0...__w
w__2..ww__ww.__w
wA__0...___w.__w
w___0....__ww._w
w..1......__w..w
w.....2ww..2w..w
w..0.___w......w
wwwwwwwwwwwwwwww
