wwwwwwwwwwwwwwww
w..._......__3_w
w........w_____w
w......_.__3_g_w
ww...3...__.___w
w_.....ww.w____w
w_3....ww.ww...w
w__.....w2...w.w
w._.....w__..w.w
w..w1..w___.ww.w
w.w._ww._www.w.w
w.w__1_____3...w
w_00____2_w....w
w1______..3...2w
w__2__A_.2..3__w
wwwwwwwwwwwwwwww
