wwwwwwwwwwwwwwww
w____222333____w
w_20_2_11111_w_w
w_2_wwwwww1gww_w
w_20w__1_wwww__w
w_2_w_311_ww___w
w12___2w1ww1__0w
w1_2_00_111111_w
w1_2__200001_3_w
w____wwwwwwww__w
w__ww3____22_22w
w__w_A__w__2__2w
w__w___1112_22_w
w111_11_21111__w
w_______3______w
wwwwwwwwwwwwwwww
