wwwwwwwwwwwwwwww
w..............w
w..............w
w..............w
w..._0.....1...w
w...__0........w
w..._____......w
w...1____..___.w
w......__.w_10.w
w......__www...w
w.._0..___w....w
w.___..........w
ww__1........._w
w___0....w..___w
wA__0...w..___gw
wwwwwwwwwwwwwwww
