wwwwwwwwwwwwwwww
w..............w
w....11w__.....w
w...._____.....w
w_...__w__....2w
w_...__w__....Aw
w_..._3w__....3w
w......w.......w
w_...0_w_3....1w
w_...wwwww.....w
w_....._w......w
w_2...wg_......w
w__...._w......w
w_0....3w......w
w0_...........3w
wwwwwwwwwwwwwwww
