wwwwwwwwwwwwwwww
w____...0...___w
w____........3_w
w__..........._w
w11...w22_..w..w
w.....w___3..w.w
w.....___..w30.w
w.__.____0.w_3.w
w.__.__11......w
w.__...........w
w.w0........22.w
w.........2___.w
w_........__A..w
w_____.1..3....w
wg___w.........w
wwwwwwwwwwwwwwww
