wwwwwwwwwwwwwwww
w.....w_...._w1w
w....._.....__3w
w....._..__....w
w....w_.222....w
w..._w_.___.3_.w
w..._w_._______w
w..._w1.___wwwww
w0...w..___....w
w__._w.._A_._..w
w12_w...0__..._w
w____wwwwwwww_1w
w___....___w.._w
w_g_..3____..._w
w_2...w____.._3w
wwwwwwwwwwwwwwww
