wwwwwwwwwwwwwwww
w..._........2_w
w..._....._...Aw
w......w.__....w
ww......1_...._w
w_.2....____.1_w
w_0__..____w...w
w__www.__......w
w._w_w.____....w
w..w_..w___..3.w
w.w.__0w_g_..w.w
w.w__1_ww__....w
w_.0___.www....w
w1_____.......2w
w____02.....3__w
wwwwwwwwwwwwwwww
