wwwwwwwwwwwwwwww
w0___A_1333____w
w______33_33_22w
w_.11.33____22_w
w__11331..3.2._w
w_._...._....g_w
w._1..11_3.0..0w
w.1____.3......w
w_.11..www...._w
w.w..w._..www__.
w._.....1...ww_w
w.__.....1_..._w
w_._11....0.w__w
w____1_._._.w._w
w___._____2_.._w
wwwwwwwwwwwwwwww
