wwwwwwwwwwwwwwww
w112_2200302002w
w22201000000000w
w2_2220w00w0A000
w220200002w0000w
w2_2220000w0000w
w_012w0w0ww0000w
w22www0w0000000w
w22232000000200w
w3_2220w0000000w
w122w2000w00000w
w1_03ww00000100w
w22w03000000000w
w32013300000000w
w112132101g0011w
wwwwwwwwwwwwwwww
