wwwwwwwwwwwwwwww
w..___.........w
w....11w__.....w
w....____2__g__w
w_...__wwwwwww1w
w0...__w.......w
w_..._3w.......w
w0...._w....w.ww
w_...0_w....wwww
w_...wwwww.....w
w_....__.......w
w_2..._........w
w__..._........w
w....._.21.....w
w1_2.._.3_A_...w
wwwwwwwwwwwwwwww
