wwwwwwwwwwwwwwww
w1__..___...3_Aw
w....w___...3__w
w....w___...___w
w.....111....__w
w............__w
w_w0....._w.._1w
w_w_....._.....w
w_w_....__.....w
w_w_...._1.....w
w___...........w
wwww...2....___w
w....wwww..._w_w
ww...w___..._w_w
wg....3___..2w_w
wwwwwwwwwwwwwwww
