wwwwwwwwwwwwwwww
w.....____0...1w
w....3_ww_2....w
w....._ww_2....w
w....._ww_.....w
w....._ww_1....w
w....._w._.....w
w.....1........w
w.....00....wwww
wA_w_......_w_gw
w._w_2....w_w_ww
w._w_.....w_w_.w
w2_w_1....w_w_.w
w1_w_0....._w_.w
w.___0...2.___.w
wwwwwwwwwwwwwwww
