wwwwwwwwwwwwwwww
w.....w_...._w1w
w___.._.....__3w
w0__.._____..._w
w___..wwgw__.._w
w___.._www__3__w
w_....3..._..__w
w........._..www
w0.......__....w
w__........._..w
w12_.........._w
w___.......ww_1w
w___...._._w..Aw
w0__.w2_.2...._w
w__..w_____.._3w
wwwwwwwwwwwwwwww
