wwwwwwwwwwwwwwww
w._1__1_w_.....w
w_w_g______._3.w
w_..__......_www
w_..w.www..__.ww
w.._.0___.._w_Aw
w.w..w__w__ww__w
w._.______._ww_w
w_.._._...2.3__w
w__www__.__.3__w
w__w_.__2___.11w
w_w.....__w_...w
w_w0._.__w___._w
w_____.._w...__w
w2__0..._..___.w
wwwwwwwwwwwwwwww
