wwwwwwwwwwwwwwww
w.A.___22_0__2_w
w__.____.....__w
w2____.00__2w._w
w._w.121_333_._w
w._w2__0.2.__._w
w.w0_2_003ww2__w
w_.__231_w_._20w
w_00___.w__..02w
w_0w2wwww13w_00w
w3_._w_w___w.02w
w__0.g20www2303w
w_.03_.23__.3__w
w__w__3_33_.33_w
ww..2__.__..__0w
wwwwwwwwwwwwwwww
