wwwwwwwwwwwwwwww
w111_____1__...w
w11_11_.___..2_w
w___.._..___.._w
w___.....__w..Aw
w__._ww.._0w.__w
w_...w___..ww_ww
w.._.w___.0.3__w
w0....g__._....w
w__ww...w.w.___w
w..._...w...0__w
w_.w.w.ww...0__w
w.w__.......__3w
w...........__.w
ww..._.......w.w
wwwwwwwwwwwwwwww
