wwwwwwwwwwwwwwww
w_1_._..w_3_.._w
w_1_.._.ww.....w
w____._3_....._w
w.____3__w...._w
w___..__w....._w
w__._w_._.___._w
w0..________.._w
w_._____.w___._w
w..g_...__..___.
w.w.......__.._w
w2__...........w
w_ww0...A...__1w
w____.ww_....w.w
w_____0.___3___w
wwwwwwwww_wwwwww
