wwwwwwwwwwwwwwww
w__332___0__0__w
w__03w_100100w_w
w___3w1ww1_01w_w
w_www1_000_01__w
w_w0110w0____g_w
ww1_012__11113_w
ww1_100__0w_13_w
ww12000___w013_w
w__1w1____w013_w
w_0wwA10_0_0132w
w__0ww111__113_w
w0_w_ww1_1www00w
w0_00000www1ww0w
w__0____3..00__w
wwwwwwwwwwwwwwww
