wwwwwwwwwwwwwwww
w_........w....w
w_..w..w..w...3w
w_..w....w...3_w
wwwwwww2....._gw
w_______0....__w
w......www.....w
w..............w
w..............w
w_.....320...._w
w_w2...___..3w_w
w_w_..._.A.._w1w
w1w_..._._.._w_w
w_._..._._.._._w
w___...3_3..___w
wwwwwwwwwwwwwwww
