wwwwwwwwwwwwwwww
w0__31.__1..1__w
w3333.___...__Aw
w3__..g0.._21__w
ww3_.0_....0_13w
w__.__0.0.._2_1w
w__.___.._w0220w
w0.__www.__._2.w
w__..w__ww__w_.w
w..0ww___..w_0_.
w..0_____www.w.w
w0.w___._ww_.w.w
w_._w__..0_w_w.w
w__2w22__ww._..w
w____22_._...._w
wwwwwwwwwwwwwwww
