wwwwwwwwwwwwwwww
w___0____A____1w
w2_ww.__..__._1w
w20w...w__.w_..w
w21w_..__2ww_._w
w1_w._.__w____.w
w_w..33_www2___w
w._w_w22ww_._w_w
w_w..w22.__._w_w
w.w..w_____.3w_w
w._..w3___w._w_w
w_g_.w_..__._w_w
w__..wwww_wwww_w
w___w.__._.3___w
w00........._33w
wwwwwwwwwwwwwwww
