wwwwwwwwwwwwwwww
w.0w11_22_133__w
wg_0__0_..___2_w
w.__...03..02__w
w._1_111_..0..1w
w__.2.1..3._310w
w_.123_.03_0___w
w_12_.w_....__0w
w___.1_.0_....2w
w_2__._1_332__0w
w_3..2_.A2__._2w
w__.....___30._w
w_1.0._03333.__w
w_.33_1..0.._1_w
w_._3..2__1_1__w
wwwwwwwwwwwwwwww
