wwwwwwwwwwwwwwww
w_...._3w._g__.w
ww.....w....__.w
w_..w...ww.._..w
w...w._1_www...w
w...w._........w
w.www._._.ww.__w
w__..._3....._.w
w_1__wA___0..__w
w....w__ww..2_.w
w........w.....w
w_....._.w.....w
w_..ww2_w...___w
w..._.ww...._..w
w..._....0_.w..w
wwwwwwwwwwwwwwww
