wwwwwwwwwwwwwwww
w3._0..._....__w
w___..__..._.._w
w_0_...w..._w..w
w___...w.22.w._w
w___.....22.w_.w
wAw.....w222w._w
w.wwwwww.....w1w
w2w......www..1w
w.w.00........1w
w..0003.w..ww.1w
w.w_00_....._.1w
w...0.2.wwg33.1w
w._.w.00w.w3311w
w__..__...ww.__w
wwwwwwwwwwwwwwww
