wwwwwwwwwwwwwwww
w...0..1..___www
w.........3____w
wwww2........__w
w____.....w..__w
w.______0.w.___w
w..1........101w
w..............w
w.......www....w
w.....___1w....w
w2....w___w....w
w_.....w__w....w
w__.....w_w..w.w
w__..........__w
wA___3...0.2w_gw
wwwwwwwwwwwwwwww
