wwwwwwwwwwwwwwww
wA____0..______w
w______..01____w
w............1_w
w_____....3...3w
w_____0........w
w__1...........w
w1.............w
w...........w..w
w__...__2_0.w__w
w__3.._____.ww_w
w_0..._____.w__w
w_2...__1__ww__w
w_1...___www.__w
w_0..._...ww._gw
wwwwwwwwwwwwwwww
