wwwwwwwwwwwwwwww
w._0.._w_..3___w
w___..___..3__2w
w.....111......w
w___......ww...w
w___.ww.www___.w
w....w___ww__3.w
w__..w___w.....w
w__..wwgww.....w
w.....www....22w
w20.........w__w
w__.........w__w
w__..._1_..ww__w
w__..w___w.ww__w
w__..3_A_0..___w
wwwwwwwwwwwwwwww
