wwwwwwwwwwwwwwww
w_.._..._1_._3_w
w0.0.0_....1_._w
w..0....w.....1w
w......wgww_0..w
w_1_w.__.____.2w
w_.w...w._2__._w
w_..__.w_.2__._w
w.w...__._0.ww.w
w..w3_._20._w..w
wA_w.._2_0__.3_w
w__w.._...w____w
w___.ww..w..._ww
w__0_._.2..33..w
w23_._.__.__.2_w
wwwwwwwwwwwwwwww
