wwwwwwwwwwwwwwww
w______________w
w__..__________w
w_1___ww___1___w
w_1__..w_______w
w_______w___0__w
w__w1___ww__w__w
w_____0__ww____w
w__w______333__w
w____3___3000__w
w__w_w____0___2w
w________0_w__2w
w__w__11___wgw2w
w__w__www_2ww_2w
w_____wwA__ww__w
wwwwwwwwwwwwwwww
