wwwwwwwwwwwwwwww
w1..__ww....._gw
w....0.......__w
w2.............w
w____0.....wwwww
w______........w
w____wwwwww....w
w_...______3...w
www..______0...w
w..............w
w............23w
w23..........__w
w__02........__w
w_____0......__w
wA_____0.2w.___w
wwwwwwwwwwwwwwww
