wwwwwwwwwwwwwwww
w___...____222.w
w0w_________...w
w0w__..w_______w
w0____ww_3_____w
w2_w._w__33____w
w._.._..0___.._w
w.__.._.www__.0w
w._.__3.w_ww_.0w
w0.A__._w._w_._w
w.w22..w_____._w
w.wwwwww__w____w
w__.__________ww
wg_______w_w...w
w_____111_0....w
wwwwwwwwwwwwwwww
