wwwwwwwwwwwwwwww
wA0000000000000w
w22222222222220w
w22222222222220w
w22222222222220w
w22222222222220w
w22222222222220w
w22222222222220w
w22222222222220w
w22222222222220w
w22222222222220w
w22222222222220w
w22222222222220w
w22222222222220w
w2222222222222gw
wwwwwwwwwwwwwwww
