wwwwwwwwwwwwwwww
w___.w___1__0..w
w_1__w_3____0__w
w_._.____w__00_w
w...._g.____00_w
w...._w_0__.00_w
w...._w_0_._.._w
w...__w____..._w
w.33330......._w
ww___2_......._w
w______......._w
w_00.........__w
w_30_0.......1_w
ww____A_____11_w
w._.__1____..__w
wwwwwwwwwwwwwwww
