wwwwwwwwwwwwwwww
w.w111111____._w
w._A____._.3_.gw
w0....____1w_._w
w_._..ww...w_._w
w...._w._.ww0._w
w.0.._w._w..w..w
w_..._w_.w.._..w
wwwww.w.....___w
w_.._..w._.w_..w
w___._.w_..ww..w
w_._....3..ww_.w
w1wwwwwww.11_...
w._..._...__...w
w.__0_0___.__..w
wwwwwwwwwwwwww..
