wwwwwwwwwwwwwwww
w_______1______w
w333___________w
w___3_2_2__0___w
w____.A22_0_1__w
w3__..________1w
w3__.._0_1_2_1__
w______0_____0_w
w____110__23___w
w__.._0_._2_3__w
w__.__1_0______w
w___0__11_2_3__w
w3_.0__1___3_1_w
w__.111__3_2___w
w___________g__w
wwwwwwwwwwwwwwww
