wwwwwwwwwwwwwwww
w_..___2._1___Aw
w1__._1...._3._w
w.__...........w
w.__.......0..1w
w_w__..wwwwww..w
w_w_....3..__._w
w_w___.....__._w
w.w......wg....w
w.__.3_0.__w...w
w.__.._.2ww....w
w___.__.__3ww..w
w_1_.ww__....__w
w.....w.....___w
w___2.w__2_._.3w
wwwwwwwwwwwwwwww
