wwwwwwwwwwwwwwww
w_.____._______w
w____2..___0___w
w_33___w__0..__w
w_3_ww____..__2w
w___3_22______2w
w_ww__0_22__w_2w
w_1_www__wwA__2w
w___w.w____ww_2w
w_g__w__1__w__2w
w____w._13_33__w
w_3w_w._1__30__w
w_3___w.00000__w
w_322__00__11__w
w_3____________w
wwwwwwwwwwwwwwww
