wwwwwwwwwwwwwwww
w....__________w
w__._..........w
w_......_......w
w___.___w..__._w
w__.._w_ww___._w
w__.._______.._w
w............._w
w_..__........_w
w_0._w_........w
w_.._g_...___3.w
w_....._w._2__.w
ww....._w.2A2_.w
w_0...._w.____.w
w_.......3____2w
wwwwwwwwwwwwwwww
