wwwwwwwwwwwwwwww
wg3_3.w_.......w
w.._.._........w
w....._____....w
w___..3____...3w
w_12..wwww0..._w
w_....w..._....w
w.....w..._....w
w0....w0.__....w
w__ww_w00_.....w
w______A__.....w
w.w1.1___......w
w..............w
w..............w
w..............w
wwwwwwwwwwwwwwww
