wwwwwwwwwwwwwwww
w3A13112_021111w
w33311111111101w
w31131111311001w
w_31_1_11111100w
w_12331__w_1100w
w_2_03ww_w_1310w
w13332_____0000w
w_33____w__1_00w
w0333_w_w__2010w
w3_2_322222__02w
w32333222222002w
w3_332222222200w
w2322222222_202w
w_0___2_222222gw
wwwwwwwwwwwwwwww
