wwwwwwwwwwwwwwww
w....____..____w
w_...0....._...w
w_....._......3w
w__........1___w
w............._w
w__ww.__..._..Aw
w..w.........._w
w_.w_2.......3_w
w..w0._1wwwww.2w
w_.wwww...__...w
w......_w......w
ww....._w......w
w__...._w......w
w__...0_.._...gw
wwwwwwwwwwwwwwww
