wwwwwwwwwwwwwwww
w__0__...___0__w
w__w______wg___w
w_ww.._.__ww_1.w
w0_wwwww1....._w
w......w...._._w
w....wwww.2_.2_w
w___....w.w_1._w
w__0_...ww.____w
w.......w..1.3_w
w.......w....__w
w.....A_w_...__w
w......_w....__w
w.._____w....__w
w_.__0___...2__w
wwwwwwwwwwwwwwww
