wwwwwwwwwwwwwwww
w_1_._..333____w
w_1_.._..._____w
w____.33_3_1___w
w.____3_.33____w
w___.._._.._31_w
w__....._____1_w
w0..3..._ww3_..w
w_...._____._..w
w....._g_._.__..
w....00_____...w
w.....0_.......w
w_..0_0._...__.w
wA__0.0._____w.w
w__2._0.___.___w
wwwwwwwwwwwwwwww
