wwwwwwwwwwwwwwww
w_311__1222221_w
w_3__1112133333w
w1_33331wwwww__w
w_11123_w_www_1w
w__2_133___w_w_w
w__2w211333__w_w
w_22w_31113_ww_w
w_20ww__101__w_w
w_222wg___1__w_w
w_22Awwwww3__w3w
w1_2__ww_223ww_w
w1_w_22_121_2__w
w1111____3333__w
w_1__1______3__w
wwwwwwwwwwwwwwww
