wwwwwwwwwwwwwwww
w.0_________w__w
w_0_ww_22____w_w
w_0.______w0___w
wg0__www__w_3_.w
w___ww__0_w_3__w
w_w3______w__0_w
w_ww...0___ww._w
w_w....__1_____w
w_w_11._113__2_w
w_w_...__0_w___w
w_3ww__________w
ww_33_wwwww_w__w
ww_11__1___w_A_w
w___11________.w
wwwwwwwwwwwwwwww
