wwwwwwwwwwwwwwww
w_....__w._w___w
ww.........._3_w
w_..w.......A3_w
w...w....www___w
w...w._..w..1_0w
w.www._..w...__w
w._..._......_.w
w___.w..._...__w
wg___w.ww0..__.w
w___....._.....w
w......_._.....w
w__._.__....__3w
w22._......._..w
w..._....0_.w..w
wwwwwwwwwwwwwwww
