wwwwwwwwwwwwwwww
w0..___....3A__w
w_...__.1____._w
w_..._...0_..._w
w__......_...._w
w1_.....w....._w
w.__._____...._w
w___.__g___...3w
w0__.___..0....w
w..1......_....w
w......._____..w
w_...__.___._..w
w.._.__..www_._.
w.0._____w._000w
w.__.._.2_.__.ww
wwwwwwwwwwwwww..
