wwwwwwwwwwwwwwww
w_____.___.____w
w_3__www_ww_A__w
w_____________ww
w__2___33_33___w
w_____3___._3__w
w___ww0__1__3___
w_1_ww.0__0___2w
w31_______0____w
w____w_0__22___w
w1______2__22__w
w_1_w__2____0__w
w__11__2.__0___w
w_g_w11100__0__w
w___w....___.__w
wwwwwwwwwwwwwwww
