wwwwwwwwwwwwwwww
w______________w
w__w___ww______w
w__w__ww__222__w
w__w__ww220___1w
w__w_1_w_300___w
w__w_1_w____3___
w__ww__w_3_23__w
w2__wg_______31w
w_2_wwwwwwwww3_w
w_2_w0_____Aw__w
w___w001113_w__w
w_www_00_1__w_3w
w______0w13_w__w
w___2_______w__w
wwwwwwwwwwwwwwww
