wwwwwwwwwwwwwwww
w______________w
w0_33__2_01_w__w
w0333wwwww__2__w
w_3ww___w.w_22_w
w_w31____w.w_22w
w_w_3_22__ww_22w
w_ww3ww__2_ww_2w
w_w__000__3___2w
w_w__0__003_w_2w
w__w_0w_g100_32w
w_1_22_www_0_23w
w2113000___022_w
w1__11_3___0_3_w
w_A_________0__w
wwwwwwwwwwwwwwww
