wwwwwwwwwwwwwwww
w____0....__0__w
w_.......3_____w
w1........13.__w
w............__w
www..........1_w
wgw...........ww
w_.............w
w_.............w
w_......3......w
www............w
w.............2w
w...........23_w
wwww....2..3___w
wA____0....____w
wwwwwwwwwwwwwwww
