wwwwwwwwwwwwwwww
w_11._..333_1__w
w_11.._...___1_w
w____.33_3_11_Aw
w.____3_.33____w
w___.._._.._31_w
w__..3__3__w11_w
w0.03_..3ww3...w
w_._....3w3....w
w._.3.3.ww_.._..
w._...._1ww_...w
w.__.._.._.....w
w_..1_ww.w._._.w
w____1w0_.__ww.w
w___.___www_g__w
wwwwwwwwwwwwwwww
