wwwwwwwwwwwwwwww
w1_0..___w..3_Aw
w....._2_w..___w
w.....___w..1__w
w.....310....__w
w............__w
w2w2....1_..._3w
w_w_....__.....w
w_w_....__.....w
w_w_....3_.....w
w___...........w
w__1........___w
w....wwww..._w_w
ww...w_20..._w_w
wg.3.w____..3w0w
wwwwwwwwwwwwwwww
