wwwwwwwwwwwwwwww
w______.w.3____w
w___11_...3____w
w__2....w...31_w
w___.3www....._w
w1....www.__.._w
w.wwwww1..3__._w
w..........__._w
w.ww.......w_._w
w.w____3__ww_._w
w.w____3__ww_._w
w.w_2......._._w
w.w_0._______w_w
w_w_0.__A__..._w
wgw_0..........w
wwwwwwwwwwwwwwww
