wwwwwwwwwwwwwwww
w______________w
w____wwwwww____w
w___www.._w_3__w
w__ww.....3w_33w
w3_w....._.w333w
w3_w..0_...w_33_
w3_w__..__w_g__w
w__w..____w___ww
w__www_0__wwwwww
w1______2______w
w13________0___w
w13_2__2_20__A_w
w11_22__2200___w
w_1___22_______w
wwwwwwwwwwwwwwww
