wwwwwwwwwwwwwwww
w__0........__gw
w_wwww......w__w
w__...3..._....w
w_1._______....w
w_..____.....01w
w1..ww..2....__w
w......._....__w
w.2....__0...__w
w__2....__ww.__w
wA__0...___w.__w
w___0....__ww._w
w..1......__w..w
w.....2ww..2w..w
w..0.___w......w
wwwwwwwwwwwwwwww
