wwwwwwwwwwwwwwww
w._...11_____..w
w__.1..____0___w
w_..______w0___w
w..__www______.w
www_ww__0ww___.w
w_w3____0_w__0_w
w___3300___w_._w
w_____0____w___w
w___ww0_g_3w0__w
w2__w____0ww0__w
w_3__2____w__w_w
w__33ww_www_1__w
w______11_113__w
w_A_____33333_.w
wwwwwwwwwwwwwwww
