wwwwwwwwwwwwwwww
w______________w
w__.._2_2200w__w
w_1_w__.__11___w
w_1__.._.._____w
w__________w0__w
www_1__00__ww__w
wAw___0.00_____w
w_w___0..0_____w
w_w__3_00_333__w
w3wgw____3_____w
w3www___1__w___w
w_____11_1_____w
w3_331222_222_1w
w______________w
wwwwwwwwwwwwwwww
