wwwwwwwwwwwwwwww
wA_____________w
w__1__012_____1w
w..............w
w...3wwwww22.1.w
w..__w___w__w__w
w..__w_g_w__w__w
w..__w___w__w__w
w..__.___2__w__w
w.1__.___.__w__w
w.0__...0.__w__w
w.0_________w__w
w..___1..___w__w
wwwwww.2.wwww__w
w0_______...3__w
wwwwwwwwwwwwwwww
