wwwwwwwwwwwwwwww
w112_2222322222w
w22201322222222w
w2g22222222w2A20
w22020222222222w
w2222222ww22222w
w_012222_222222w
w22ww2221122221w
w22232w22122221w
w32222322221ww2w
w12212222121221w
w1203213w132122w
w22303033112001w
w32013332331020w
w11213211120011w
wwwwwwwwwwwwwwww
