wwwwwwwwwwwwwwww
w___3......w1__w
w_____..__2w.w_w
w__w___.___w2._w
w0_w0..____..._w
w__1w_1____..3_w
w__..wwwww1.._.w
w.__3..........w
www____A_1_0.1_w
w_..._.......__w
w_.....3.__..__w
w_..2g_.__...._w
w_1.__..__...3.w
w____...2_.0._.w
w___......_3...w
wwwwwwwwwwwwwwww
