wwwwwwwwwwwwwwww
w___1.___..3_.Aw
w___..___1.._._w
w___..___..._1_w
w1.1....0...___w
w..__.........3w
w..............w
w..__0....___..w
w..ww_._____g..w
w___._.____wwwww
w.._..._____...w
w___....2......w
w___0_.._w.....w
www..._________w
w....2____.2.__w
wwwwwwwwwwwwwwww
