wwwwwwwwwwwwwwww
w______.___..._w
w_w.____..____.w
w_..0.1.._..__3w
w__w____..._1__w
w1.._._....3___w
w___....ww.._._w
w__....___ww.w_w
w__._.__._w__._w
w.........ww_._w
w_...w_w_.w1..3w
w_..2..._..._.ww
w0.._...._...__w
w__2_...__g_._.w
w_A__0....__._.w
wwwwwwwwwwwwwwww
