wwwwwwwwwwwwwwww
w___3......w1__w
w_A.....1..w.w_w
w___1__._.ww.._w
w03....__ww..._w
w_...__2.w_..3_w
w_...__......_.w
w..............w
wwwwwww____..__w
w_....w..__..__w
w.___....__.___w
w..2.._.0__.__2w
w2___...ww_23__w
w__g_.....3.___w
w___......____3w
wwwwwwwwwwwwwwww
