wwwwwwwwwwwwwwww
w_11_._1.111___w
w103._2_.2..2.3w
w120...10_....3w
w21_10..21130._w
w2..21__002333Aw
w2.._13023w.23.w
w.1._1022wg._3.w
w_3..22.3___.0.w
w_..3.ww213w_3.w
w3.._30w_2.w0.2w
w_1.._3.w.123.2w
w0201..20__2..2w
w.0.22.1.32..3_w
w._10_._02_.._0w
wwwwwwwwwwwwwwww
