wwwwwwwwwwwwwwww
w___0__00_____1w
w__ww._00___._1w
w_0w.._w___w2..w
w_1w_..__2ww2..w
w__w._.__w____.w
w_w..33_ww.2___w
w____.2..._.3w_w
w0_...2..._._w_w
w_w...g____.3w_w
w....w3___w._w_w
w.._.w_..__._w_w
w....wwww_ww_w_w
w.._w.__._.__A_w
w..________._33w
wwwwwwwwwwwwwwww
