wwwwwwwwwwwwwwww
w.__A.__w__.__.w
w_w___3.0__.___w
w_..__0___..w__w
w__w_w._.1._w__w
w0._1._.....w.1w
w_2..___..ww_w.w
w__.___3_..w___w
w____.w___..._.w
w_0_.ww__...___w
w_._..___.._.._w
w._..3_..._...ww
w__.._.w_2.____w
w_g.__0..___.__w
w__.__..w.___2.w
wwwwwwwwwwwwwwww
