wwwwwwwwwwwwwwww
w.__.__.__..._gw
w__...____3..__w
w__..........__w
w_0._....___w..w
w_....._.0___..w
w..3_2__..____ww
w.1__ww2w1_w__ww
w___wA__._w..__w
w__.w___._w._21w
w__2w_____.www.w
w._._w_w_.__w..w
w____www__..w__w
w_0..__w___....w
w__._____3.....w
wwwwwwwwwwwwwwww
