wwwwwwwwwwwwwwww
w0_____g...._w1w
w...........___w
w..............w
w..............w
w...........3_.w
w..........2___w
w..........wwwww
w0.............w
w__.........__3w
w12_.........__w
w......1....._3w
w............__w
w.....3_0....__w
w.....wAw...._3w
wwwwwwwwwwwwwwww
