wwwwwwwwwwwwwwww
w_2____wwww..g_w
w_000000___ww._w
w___________ww_w
w_....www__3_w_w
ww___0__ww_33__w
w____000__w33__w
w_112200__www_2w
w_112200____ww.w
w___1__00_33__.w
w__ww_ww__33__.w
www_____ww_3___w
w__2222__w_33__w
wA_22_22_w__3_2w
w________...__1w
wwwwwwwwwwwwwwww
