wwwwwwwwwwwwwwww
w__0..........gw
w___........ww_w
w__0.......ww__w
w___.......w___w
w__0.......w__.w
w__0.......w__.w
w___wwwww...__.w
ww_______...__.w
wwww...__......w
w......__.....0w
w......__....._w
w___0..__w...__w
wA__0..__w...__w
w___0..__....__w
wwwwwwwwwwwwwwww
