wwwwwwwwwwwwwwww
111_...__12222_w
w_w__..3_____A_w
w_w__..w_______w
w..___ww_3_.___w
w2.w._w__33.___w
w...._..0___.._w
w.._.._._____.0w
w._.___._.___.0w
w..___....___._w
w.___..______._w
w.w_w..w__w____w
w__..________www
w222____wwwwww.w
w______g__0....w
wwwwwwwwwwwwwwww
