wwwwwwwwwwwwwwww
w__________00__w
w___www_____000w
w______w111_0_0w
w_____33w______w
w_w1___3_w_1w__w
w_w___223_w_w___
w_w_2___30w1w__w
w_w____0__w_w__w
w_1w2___3wgww__w
w_1wwwww_3_2w__w
w___11_1___2w_Aw
w____2_12_3_w__w
w__0____1__3w__w
w__0________w__w
wwwwwwwwwwwwwwww
