wwwwwwwwwwwwwwww
wA_________..wgw
w___w._____..__w
wwwww._____..__w
w.....__2__....w
w...1._3_0_....w
www...__1__....w
ww__........__.w
w.___0......_2.w
w..............w
w.....___......w
w.....3_0.....1w
w.....__ww.....w
w__.3...ww..___w
w_2........____w
wwwwwwwwwwwwwwww
