wwwwwwwwwwwwwwww
w2_2_w__0______w
w______0___..._w
w_0....w__.__..w
w___...__.2___.w
w_g_...3...w__.w
w1__.w33wwww___w
w___.wwww__.311w
w.._ww_.w__._1_w
wwww_.w_w__.0_Aw
w___.._____.___w
w...11__w__._w_w
w...111_w__w__2w
w...111__0__..1w
w__________..33w
wwwwwwwwwwwwwwww
