wwwwwwwwwwwwwwww
wA___0_...w___gw
w_____0...www__w
w__10.1.www____w
w.......___.___w
w.......0__..__w
w...........w__w
w1ww........ww_w
w____0........ww
w.____.w__2__..w
w.___0.w_1__0..w
w.ww__.w___w...w
w..._0..._ww...w
w0.3__.........w
w...2__........w
wwwwwwwwwwwwwwww
