wwwwwwwwwwwwwwww
w1000000000000Aw
w12222222222220w
w12222222222220w
w12222222222220w
w12222222222220w
w12222222222220w
w12222222222220w
w12222222222220w
w12222222222220w
w12222222222220w
w12222222222220w
w12222222222220w
w12222222222220w
w1222222222222gw
wwwwwwwwwwwwwwww
