wwwwwwwwwwwwwwww
w__.0___3.w__..w
w__..w...w.....w
w10____w.w..__.w
w1..0..__w..__.w
w...w..__w.w_w.w
w.w.._.._0.....w
www.__.w__.w.w.w
w.w..w.3_g...w.w
w.__w_..._...__w
w..w_..w..___..w
w2.._.......w..w
w_..w_2....ww..w
w__0.._2...3_.2w
w_0_.__ww...A__w
wwwwwwwwwwwwwwww
