wwwwwwwwwwwwwwww
w.....w_...._w1w
w__..._.....__3w
w_A_.._........w
w___...........w
w_1.........3_.w
w_...........__w
w............www
w0......___....w
w__._w.____._..w
w12_w...0__..._w
w____ww_wwwww_1w
w___....___w.._w
w0__..3____..._w
w__...w__g_.._3w
wwwwwwwwwwwwwwww
