wwwwwwwwwwwwwwww
w....____..____w
w_.........3...w
w_.....1.......w
w_1...3_w..._._w
w.....A_w..._._w
w__ww..2..._.._w
w..w......www._w
w_.w__....w__._w
w_.w.._........w
w_...._...__...w
w......_w......w
ww....._w......w
w_0...._w...._.w
w_g....0..____2w
wwwwwwwwwwwwwwww
