wwwwwwwwwwwwwwww
w__1111_00_____w
w__.__...__ww__w
w__........____w
w_.__._...._.._w
w__...w..._..__w
w_____..w....__w
wA_.__.._.0..__w
w___330030...._w
w____________w_w
ww__w_w__ww..__w
w_2222_________w
w___w____.www_gw
w________ww.___w
w__w___www___._w
wwwwwwwwwwwwwwww
