wwwwwwwwwwwwwwww
w__....._....__w
w_..___000__.._w
w_.3w__0__ww___w
w___ww_w_w_____w
w____1w______22w
w_w3_10_0_w___2w
w______w3__w_22w
w___1__w3_222__w
w__0___________w
w_w_1___03_____w
w__11_w_3_30___w
w_1g3w___33_0__w
w______33____A_w
w______________w
wwwwwwwwwwwwwwww
