wwwwwwwwwwwwwwww
wA_____________w
w__1__012_____1w
w..............w
w...3wwwww22.1.w
w..__w___.__w__w
w..__w_g_.__w__w
w..__w___.__w__w
w..__w___3__w__w
w.1__w___w__w__w
w.0__wwwww__w__w
w.0___..____w__w
w..___1..___w__w
wwwwww.22wwww__w
w0_______...3__w
wwwwwwwwwwwwwwww
