wwwwwwwwwwwwwwww
w______........w
w_...____......w
w_..w.w..__....w
w...w.....__wwww
w1..........___w
w__..w_.....3..w
w..w.__w..._...w
w.w..g_w..___..w
w.w.......___..w
w_0.....__.....w
w__....www..._3w
w__w_.....w.__2w
w_0..2....ww_www
w_____2...3___Aw
wwwwwwwwwwwwwwww
