wwwwwwwwwwwwwwww
w0...___......1w
w__..___3______w
w__...2..____..w
w__0......___..w
w.1........__..w
w..w.......___.w
w.....31.w.._..w
w..w_3__.......w
w...____0.._...w
w...A___.......w
w..w...........w
w2.www_w.......w
w_...__w_...._.w
w_..3__w_...g__w
wwwwwwwwww..wwww
