wwwwwwwwwwwwwwww
w_________0____w
w0000A_22011w__w
w0__3323_0_0w__w
w__wwwwwww__w0_w
w11w1_22_w__2__w
w1_w__22__w2222w
w1_w_www22_w_2_w
w1w___1w133w___w
w1w___w_3_3ww__w
w1w__1w_g1_ww3_w
w1w_22_wwwww__3w
w1ww3233___003_w
w1__w2_3300033_w
w_______00000__w
wwwwwwwwwwwwwwww
