wwwwwwwwwwwwwwww
w___....3ww..__w
w__._...w.wwww_w
w____w..w..._w_w
w_..ww..w__..._w
w_..ww.w_....3_w
w_...ww._...._.w
w...w.._0......w
w...w..w.._..w.w
w_..w....__...2w
w..ww...._..1__w
w._wg_____..__.w
w..___._.__.3__w
w_.0........___w
w___.......3_A3w
wwwwwwwwwwwwwwww
