wwwwwwwwwwwwwwww
w.0_A__ww___w__w
w_____ww_0___w_w
w__.__w___w22__w
w____www____3_.w
w3___w__0_w____w
w3w3_wwg__w__0_w
w3ww..w____w_._w
w3w.ww.w_1_____w
w3w__1www1___2_w
w_w___w__w_____w
w_____w__w__22_w
ww1_3w_22_w__2_w
w_1_____2__w___w
w1_ww1__2_____.w
wwwwwwwwwwwwwwww
