wwwwwwwwwwwwwwww
w3_____2____.__w
w33....___..__.w
w33...._....__.w
w333.....____..w
w__w...__....w.w
w___.._________w
w_w...www_www__w
w_w_...________w
w_0....___._w_2w
w___..______w_2w
ww__www_w__w1_2w
w00_0__www_w1__w
w_A_____ww_1_g_w
w_11_.w0.__w...w
wwwwwwwwwwwwwwww
