wwwwwwwwwwwwwwww
w..1g1..w......w
w.......wwww...w
w.......__...__w
w..._....___1w1w
w.._0_.....___.w
w..__0.....__2.w
w.._A_.....__.ww
ww.___....____ww
w0.3_0....__3_2w
w_........____.w
w_.......__....w
w_...._......._w
w_0____.__3_..1w
w2_222_.3_0__0_w
wwwwwwwwwwwwwwww
