wwwwwwwwwwwwwwww
w..._..0......3w
w....0...__..3_w
w..0..._.wwwww_w
ww._._._.w.2___w
w_.__.wwww2____w
w_3_ww0...._.__w
w__w__1.....3_.w
w._A____w__.._.w
w.__.11.___.w_.w
w__...ww_www._.w
w0w...w.___3.__w
w_01..w0......_w
w__.ww._......_w
w_______3.....gw
wwwwwwwwwwwwwwww
