wwwwwwwwwwwwwwww
w_____.___.___.w
w_3___________.w
w__22__.._____ww
w_22___._._____w
w_2__2A__..____w
w_2__2___1._____
w_w___.._w.__02w
w3____.___.__0_w
w_____..__.____w
w___1.__w.._0__w
w__w..____.____w
w_111_w_.__0_w_w
w_33.110___g___w
w______110__.__w
wwwwwwwwwwwwwwww
