wwwwwwwwwwwwwwww
w__..____...3__w
w__..w.....3__Aw
w._0..ww..._ww_w
w.1...0.gw.._w1w
w..w....ww.w_w.w
w...__.........w
w...__.w._.w.w.w
w....w......w_.w
w.__w_...w2____w
w..w_....__3__.w
w._._.._._..w_.w
w2.._1._...ww2.w
w_0_._2w.w..._.w
w_._.____...3__w
wwwwwwwwwwwwwwww
