wwwwwwwwwwwwwwww
w..____11______w
w._________www_w
w___0__wwww..__w
w_00__w3_gww.3_w
w_0___w3_w_w_.1w
w0__2.w3w_.w.___
w0____w3___w.0_w
w0___11_____w__w
w___.__1.___w_3w
w_2___._1w__w_3w
w___2___1__.w__w
wwwwww_w____w__w
w______...1____w
w___0__0000_A__w
wwwwwwwwwwwwwwww
