wwwwwwwwwwwwwwww
w____1.__...3__w
w..01_._.._.w_1w
w_......_...ww.w
w_ww....ww._.w.w
w_.......w.....w
w_.......w..._.w
w........w.....w
w.0__.....gw...w
w...w.ww_._w...w
w2.www._.....3_w
w_.w..._.....__w
w__._.._....__2w
w_.w_...__..3__w
wA___0_.__...__w
wwwwwwwwwwwwwwww
