wwwwwwwwwwwwwwww
w....w_g.......w
wwww.w__...33_.w
w___..__...2__.w
w__1......____.w
w._0......__ww.w
w._0......www..w
w.._wwwww......w
w...www_10.....w
w....ww___.....w
w.....w__..._2.w
w.....w__...3A.w
w..........._1.w
w023__..wwww...w
w_____.......3.w
wwwwwwwwwwwwwwww
