wwwwwwwwwwwwwwww
w0..._..333____w
w._..._...____2w
w000..3________w
w.001___..3____w
w_0..._._..___1w
w.._.______ww.0w
w0103_._www....w
w__03____w.....w
w_3_..wwww_.._..
w033_ww_1ww_...w
w___w__.._.....w
w___1_ww.w._._.w
w_A__1w._.__...w
w___.___wwww..gw
wwwwwwwwwwwwwwww
