wwwwwwwwwwwwwwww
w..wwwwwwwwwwwww
w.3____ww.._g_ww
w.1___0...w____w
w.........w____w
w..ww2...ww___ww
w.3____..w_____w
w...___..www__.w
w...._.........w
w........0.....w
w...1..3__2_2..w
w......._A__...w
w.......___....w
w...2...10....2w
w..............w
wwwwwwwwwwwwwwww
