wwwwwwwwwwwwwwww
w....__10....1_w
w__...._......3w
w..............w
w..............w
w....._0._w....w
w....___._g....w
w...w___.....3.w
w............w.w
w._....__0..2_3w
w.....A___...0.w
w......___.....w
w.......2......w
w..............w
w._0.3_0.....2_w
wwwwwwwwwwwwwwww
