wwwwwwwwwwwwwwww
w._._..0......0w
w____0_..__..__w
w__0_.__._w_.._w
ww__2__.2w__.__w
w_____w._._.___w
w_0_._._wwwww__w
w_1.__.w_A__w__w
w___www_.._.w__w
w_02w....._w__2w
w1___...3__w22_w
w__w3wwww.w.2__w
w_w_w_.._w_.2__w
w__..._._____g1w
w_0...._______1w
wwwwwwwwwwwwwwww
