wwwwwwwwwwwwwwww
w______________w
w_w_w_2_22__w__w
w_w________ww__w
w_ww____...___Aw
w_.___w______www
w_._11___2___www
w_.__1___2_1_wgw
w________2__w_1w
w_2____._______w
w___.__0._3__0_w
w___00____3____w
w__11____33_.__w
w__11__ww_____1w
w______________w
wwwwwwwwwwwwwwww
