wwwwwwwwwwwwwwww
w__1_.._0...___w
w___0..__w1.3__w
w......__w.....w
w......_2......w
w..2_.....__..1w
w2.__....._1.._w
w_.3_.....w0.._w
w_.__.....ww...w
w0.____A____...w
w...____11_....w
www............w
w__ww...__...._w
w2____..__..3__w
wg__www._0..3__w
wwwwwwwwwwwwwwww
