wwwwwwwwwwwwwwww
w_11_____1.....w
w___1w_.___.___w
w.__w._..0__.__w
w.__w....__w___w
w._.www.._0w.__w
w...ww.__..ww_ww
w..w_w.._.0_31_w
w0....___._....w
w_......_.w.___w
w.w____.w.w.0g_w
w_ww.w.ww.w.0__w
w.www.......___w
w._A..ww...w__.w
w2__.__.__.__w.w
wwwwwwwwwwwwwwww
