wwwwwwwwwwwwwwww
w2______00_____w
w__.__A_wwwwww.w
w__....ww_.___1w
w_.__.w....00__w
w1_...w...00.w_w
w.__..www_00.__w
w_.._w.__000.__w
w________.._.._w
w___21w______w_w
w_wwwwwwwww..__w
w_____w________w
w__w__33...____w
w__w_333___.___w
w_g__33333___._w
wwwwwwwwwwwwwwww
