wwwwwwwwwwwwwwww
w....__.__..___w
w.._____...___.w
ww.__.wg....w_.w
w___..ww....w..w
w_.w.__ww____..w
w__w____..___3.w
w__w0_....__A_ww
w_w.w.......___w
w_w..ww..._.1..w
w_w__.w_0._...1w
w__.__w_.......w
w..___w________w
w_....www_..w..w
w2.._____._...3w
wwwwwwwwwwwwwwww
