wwwwwwwwwwwwwwww
w0__31.__1.31__w
w3333.___1___2gw
w3__.._00__1_2_w
ww3_.0_0..30___w
w__.__0.0._30_1w
w__.....0ww0w_0w
w_.___0w.._.__.w
w__...w.0w__._.w
w..033w__..__0_.
w..03__.__2_.w.w
w0.0.w..2.._.w.w
w_._._...0_w_w.w
w_12.22__0_._..w
wA___22_._...._w
wwwwwwwwwwwwwwww
