wwwwwwwwwwwwwwww
w....._g_111...w
w..............w
w......____....w
w.....3____....w
w...._w___0....w
w.....w...._...w
w.._.._2.._._..w
w0...______.._.w
w2_ww_w___w....w
w_________..__.w
w_w___0__...._.w
w____.0....3._.w
w___...___.3__.w
w000._.__A____.w
wwwwwwwwwwwwwwww
