wwwwwwwwwwwwwwww
w.___..__w_.___w
w_A_0_._.._100_w
w_.w_..__.._1_2w
w_.30.ww.w._2_2w
w___.0.1...0_w.w
w_.w...12.__._.w
w33_.w.._.w_1w.w
w_22_.00.._.3w.w
w..._..._0_w3w.w
w.2.1..____w___w
w_.w..w_3.w..11w
w__w_2.__.3..__w
w_.___ww.3.....w
w.03__.._ww.0.gw
wwwwwwwwwwwwwwww
