wwwwwwwwwwwwwwww
w__00000_______w
w_0022___wwww33w
w_111_w1__1ww3_w
w_1100w1_wg11w_w
w31__0w1_w1_1w_w
w33www211w0031_w
w33w2w21ww__w11w
ww323_2_www_w11w
ww33222221ww110w
w__3w322112www1w
w__w1___2w__w01w
w_1w_www____w01w
w_1w333__000_01w
wA____000003331w
wwwwwwwwwwwwwwww
