wwwwwwwwwwwwwwww
w___...1111222_w
w0w____________w
w0___..w_______w
w0____ww_3_ww__w
www_www__33_w_Aw
w...._..___ww__w
w.....____ww__0w
w....__33_ww__0w
w...____w._w_._w
w.._2__w____.._w
w.__w_ww___..._w
w__._3ww__.....w
w_g_ww0_2w...._w
w____w_0__..._.w
wwwwwwwwwwwwwwww
