wwwwwwwwwwwwwwww
wg_____.....3..w
w_____.....w__.w
w__w.......ww__w
wwww.1....3.w__w
w......ww....._w
w...2..ww.....ww
w______ww_2__..w
w..____ww____.3w
w...wwwwwwww...w
w223...ww....22w
w_____.......__w
w_____.......__w
w___...ww..3___w
w__........3__Aw
wwwwwwwwwwwwwwww
