wwwwwwwwwwwwwwww
w222.3__0______w
w222_._0__...._w
w_0_.._w_..w2__w
w__w_......w_._w
w__w._.....w__.w
w1_w.___wwww___w
w__w_.ww___.3w_w
w..w..w..__.___w
w..w._w____.0__w
w__w.ww_g_w._w_w
w..w_w_.._w._w_w
w..w.w_wwwww_w2w
w..____0.0.___1w
w_.A___w___._33w
wwwwwwwwwwwwwwww
