wwwwwwwwwwwwwwww
w______________w
w_g__....__11__w
w__._333_____1_w
w_._11_________w
w..___12___3___w
w._3__1_2__3__1w
w.__33_____3__1w
w.______1_3____w
w00_____1______w
w___22_______1_w
w____222_00____w
w__________0___w
w__00_____00A__w
w______________w
wwwwwwwwwwwwwwww
