wwwwwwwwwwwwwwww
w.......w_____gw
wwww....www.___w
w____...ww..w__w
w____0..ww...__w
w__1........wwww
w..............w
w......__..2..3w
w..0...__......w
w......__......w
w......ww....22w
w............__w
w2_..........__w
w__1_0.......__w
wA____2......__w
wwwwwwwwwwwwwwww
