wwwwwwwwwwwwwwww
w__0__...___...w
wg___.._____..1w
w_22....w____www
w__w..._.2.w___w
w..ww.1_...____w
w....._w......_w
w______....._..w
w_..2__....._..w
w...._______.3_w
w.....____ww.__w
w2....3___..w__w
w....1w0.w.___1w
w_____w.....ww_w
w_____0.._A____w
wwwwwwwwwwwwwwww
