wwwwwwwwwwwwwwww
w....__________w
wA.....1.......w
w_.............w
w_0........_w._w
w_.......01__._w
w_0.....3__0.._w
w.............2w
w_...0___3....1w
w_...wwwww.....w
w_....._w.____.w
w_.....gw.__2_.w
ww....._w.____.w
w_0....3w.____.w
w_.......1____3w
wwwwwwwwwwwwwwww
