wwwwwwwwwwwwwwww
w__0__...___...w
w_________g_..1w
w_22.._.wwwwwwww
w__w..__w_.._.Aw
w..ww.1_w__..._w
w....w_ww__..._w
w___.._..__..._w
w__0_._..._..__w
w.1.wwwww....32w
w..w._00_www.__w
w..w2__0__..w__w
w...w1____..3_ww
w.._____0_..ww_w
w2____000______w
wwwwwwwwwwwwwwww
