wwwwwwwwwwwwwwww
w_....__w._w___w
ww..........3__w
w_.........._0_w
w........www1__w
w....._..w...w_w
w....._..w...w_w
w....._......w.w
wA_1.w..._1_.w_w
w_...w.ww____w.w
w_.......___...w
w0__..._._____2w
w..._.__....___w
w..._._3__.._..w
w...g______.w..w
wwwwwwwwwwwwwwww
