wwwwwwwwwwwwwwww
w3._0..._...._gw
w_00..__..._.._w
w000...w__._w..w
w____..__2_.w._w
w___.3.___1.w_.w
w_w..33_w_12___w
w.ww_w__...____w
w_w..w__.A_w_.2w
w.w..w____.33.2w
w....w3__._3_3_w
w_2..w_..__33._w
w22..wwww__333_w
w22_w___w__3__1w
w22..__...ww.__w
wwwwwwwwwwwwwwww
