wwwwwwwwwwwwwwww
wA__..2__1__0..w
w___..2______..w
w010..___w___..w
w........._1_w.w
w..__........w.w
w33_1........w.w
w33__.....___..w
wwwww________..w
w.w.._____1wwwww
w.w..1_____.w33w
w0........._wwww
w....0.._w.___.w
www.___________w
w...___000...__g
wwwwwwwwwwwwwwww
