wwwwwwwwwwwwwwww
w_w.._32.....A_w
w_0333.22___2._w
w_111101111__2_w
w__2____00311_2w
w_20__0__.033._w
w_20_03333_31__w
w_.0_3_2__331_3w
w2.3__3___01__3w
w2.1__3333330_2w
w_11_01_00_3.22w
w2_233...3_002_w
w_12233232._222w
w_1__._0_..__._w
wg_w.3_.3_w3___w
wwwwwwwwwwwwwwww
