wwwwwwwwwwwwwwww
w___......w....w
w_......_.w.2__w
w0.....2__.___Aw
ww.....__.__.__w
w____...__3..__w
w1...........11w
w..............w
w.........w....w
w_.......www.._w
w..wwww_w_.__._w
w.ww..ww._.__..w
w.._0.._._.._w_w
w_._..._._.._._w
w___...3_3..g_3w
wwwwwwwwwwwwwwww
