wwwwwwwwwwwwwwww
w__03....___w__w
w_____._____._Aw
w__..._..3...._w
w0_..._.....ww_w
w...3......www_w
w....wwwww..00_w
w.._w........._w
w...w.....1..._w
w_._....._...._w
w___..._._..3__w
w___.w..__..3__w
w__ww.ww._0.___w
w__w.__ww___11_w
w0...._g_ww.22_w
wwwwwwwwwwwwwwww
