wwwwwwwwwwwwwwww
w___.w___1__0..w
w_1__w_3_0___.gw
w___.____w___..w
w__..._..._1_..w
w.___.000......w
w.__100.00.....w
w..__00.0.___..w
w..ww_000____..w
w..w.222__1wwwww
w..w.1_____....w
w..w..._...___.w
w.._.0___w._._.w
wwwA_______33_2w
w....._000...__w
wwwwwwwwwwwwwwww
