wwwwwwwwwwwwwwww
w______.___11._w
w___3__0_____1_w
w__g_ww_w__0___w
w_________w33w_w
w_2www___._w__3w
w_.___w3____00_w
w_.w____w__w_1_w
w_____w__w__w__w
w__.w__w2_ww__Aw
w__.____w__www_w
w_1_..0__w__ww1w
w___30000__ww_.w
w_1___0_0___00.w
w___0.00__w0...w
wwwwwwwwwwwwwwww
