wwwwwwwwwwwwwwww
w__332___0__A__w
w__03__1001__w_w
w___3wwww___ww_w
w__3ww_1_w_ww__w
w_3_w_www______w
w32_w_2gww_3330w
w33_w00__ww_33_w
w3_2_w2_0_w1_3_w
w___w__w__ww_3_w
w__ww______w_32w
w__w_000w__w_3_w
w0_w__01___w33_w
w0_00000000113_w
w__0____3__00__w
wwwwwwwwwwwwwwww
