wwwwwwwwwwwwwwww
w_1_._..w_3_.._w
w_1_.._.ww__._.w
w____._3_._..._w
w.____3__w_._._w
w___..__w._____w
w__._w_._.___._w
w0..________.._w
w_._____.w_g_._w
w..__ww_w._____.
w.w._ww_.___.._w
w2____.........w
w_ww0_0._._.__1w
w___w.ww_____w.w
w__A__0.___.___w
wwwwwwwww_wwwwww
