wwwwwwwwwwwwwwww
w__........_.3_w
wwww.........._w
w__.w...ww..1..w
w...w._.2www...w
w....._._...322w
w_...._.______1w
w_..wwww.ww.._.w
w_..w.wg____.__w
w_..w.w__...._.w
w.www.w.w...__.w
ww..w.__.w..w_.w
w_..ww_..wwwwA_w
w..._.___._w.1_w
w..._.........2w
wwwwwwwwwwwwwwww
