wwwwwwwwwwwwwwww
w.....__.......w
w._____________w
w.____3A_22___.w
w.2_33______1_.w
w._2___w__w.._.w
w.__www____w__1w
w__3wwww___w_.1w
w__w____w03____w
w__w_00__w3_w..w
w23______033w..w
w_w3_2___w0_gw.w
w_w_3__w_w0___1w
w_w_g3www_0___1w
w_w_______0ww..w
wwwwwwwwwwwwwwww
