wwwwwwwwwwwwwwww
w..............w
w._111___222...w
w.___33____11..w
w.1_33___ww.1..w
w.13___wwAw....w
w._3__w____w..1w
w__3_w_____ww.1w
w__3__00000_w..w
w___0w__030_w..w
w2_3__w_000_w..w
w_23_2w___3_gw.w
w_2_3__ww_3_w.1w
w_22_33_____w11w
w__________ww..w
wwwwwwwwwwwwwwww
