wwwwwwwwwwwwwwww
wg.3._1.w..0___w
w_......www_0_.w
w_......_1.3.__w
w1.......__...1w
w....ww......_.w
w...www........w
w......w...w...w
ww_1___ww._....w
w0..._ww_.w..w.w
w_....ww..w....w
w_....w.._w....w
w___......w...2w
w____...__32..1w
w2......3_0_A0_w
wwwwwwwwwwwwwwww
