wwwwwwwwwwwwwwww
w.._22222______w
w.______222222_w
w._2wwwwwww__2_w
w._ww3..._ww_2_w
w.2w32...gw3___w
w._w__...ww__1_w
w._w___www__1__w
w._w_______111_w
w._.______11w1_w
w.000000__2.w1_w
w.00____w33.w1_w
w.___w__w__ww1_w
w._wwwwwwwwwA__w
w__3333333_____w
wwwwwwwwwwwwwwww
