wwwwwwwwwwwwwwww
w3g2_2222321132w
w22221301002201w
w11112201002330w
w010_2310302212w
w133_1130312_03w
w_233300_331030w
w10132100222333w
w3233322w1_1330w
w31111322113000w
w22102100221120w
w22232020030300w
w03_30030122002w
w_3122121221030w
w20311013A10112w
wwwwwwwwwwwwwwww
