wwwwwwwwwwwwwwww
wA___0.....____w
w_____......___w
w11.........3__w
w..........._11w
w..............w
www............w
w._........3___w
w__........3___w
w__0........w__w
w__2.........www
w_...........www
w0..........__ww
wwww......2____w
wg___.....3____w
wwwwwwwwwwwwwwww
