wwwwwwwwwwwwwwww
w_______A______w
w13__________01w
w....______....w
www...1__1...www
w_ww........ww_w
w__www....www__w
w______ww.3____w
w12____ww.____1w
w.1___www.____.w
w..__0....___w.w
w..___.w..___2.w
w..___.ww.www..w
w..3__....www..w
w..___...3wg_.3w
wwwwwwwwwwwwwwww
