wwwwwwwwwwwwwwww
w...._________Aw
w....__________w
w....__2__.....w
w_..._3_0_...._w
w_...__1__...__w
w_..._____...3_w
w_............_w
w..............w
w_...0___3....1w
w_...wwwww.....w
w_.............w
w0.....2.......w
ww.............w
wg............3w
wwwwwwwwwwwwwwww
