wwwwwwwwwwwwwwww
w_00000_2___00_w
w000_022_w33000w
w222202__w_00__w
w2_333__ww_3___w
w_2_wwww_2_www_w
wA_ww___33_w..w_
www___2333_w____
ww__233__33333_w
w__233_www_111_w
w22233w_g_ww31_w
w_23_w_3___w311w
w_33w_00_www31_w
w3ww_00_ww__13_w
w33330__ww1_132w
wwwwwwwwwwwwwwww
