wwwwwwwwwwwwwwww
w3__________.__w
w__._.____.._..w
w__....g___w_w.w
ww__....__33_w.w
w..www..ww3__w.w
w..__w....wwww.w
w..__....._ww_.w
w__.w__.__A___.w
w___ww_w_ww_ww.w
w33_______33___w
w33_w______w_1_w
w33_0w2_._...1_w
w33..w0000...11w
w....w0w_0...__w
wwwwwwwwwwwwwwww
