wwwwwwwwwwwwwwww
w_....__w._ww__w
ww....._....___w
w_.w_.g_...._.3w
w.w._......._..w
w..w__1._......w
w..............w
w......__..w...w
wA___w___._..._w
w_...._w.....w.w
w0.._._...__...w
w..ww._...__.._w
w.....__......2w
w..._.____.....w
w...__2__...w..w
wwwwwwwwwwwwwwww
