wwwwwwwwwwwwwwww
w___3____111__.w
w_._.._......_.w
w._..._____....w
w___..3_A__.._3w
w_12..wwww0..._w
w_._..w..._.._.w
w....._..._....w
w0...______.._.w
w__ww_w___w....w
w_________.._..w
w_w___0__...._.w
w____.0....3._.w
w._....___.3._.w
wg__._.........w
wwwwwwwwwwwwwwww
