wwwwwwwwwwwwwwww
w__03....___w_gw
w__wwwwww___.__w
w_w..._.wwwww__w
w0_..3_.....w__w
w...3........__w
w....w_w...._w_w
w.._w.....___w_w
w...w.....__ww_w
w_._...ww_w..._w
w__....w._.....w
w___.A2w_......w
w..1___w......2w
w...___3.....2_w
w..0____...____w
wwwwwwwwwwwwwwww
