wwwwwwwwwwwwwwww
w_____.___.....w
w_3__________..w
w______0______ww
w__2_www_ww____w
w__2_1w3___ww__w
w___22___1_Aw___
w_wwwwwwwwwww_2w
w3___________w_w
w3___00____ww__w
w3_w1___w__ww__w
w33ww_2_w_wwgw_w
w_3wwwwwwww__w_w
w.33___0300____w
w._______0__.__w
wwwwwwwwwwwwwwww
