wwwwwwwwwwwwwwww
w0.._g_....3___w
w_...__.1____._w
w_..._...0_..._w
w__......_...._w
w1_.w...w....._w
w.A_w____3...._w
w___w_2__3_...3w
w0__w...3.0....w
w..1w....._....w
w...w....____..w
w_..w._.___._..w
w.._.._..www_._.
w.0._____w._000w
w.__.._.2_.__.ww
wwwwwwwwwwwwww..
