wwwwwwwwwwwwwwww
w_._..2..13_0._w
w_________w_1__w
w0_w__w__ww_1w_w
w.___.....__1w_w
w.w___...w___w_w
w____.11.wA_.2_w
w_www.11_.___2_w
w_w______ww2wwww
w_..00__.______w
w_...0.._22____w
w_...ww_22__w._w
w_.._0w___1_...w
w_.__w__.w.w...w
w_g_.wwww__....w
wwwwwwwwwwwwwwww
