wwwwwwwwwwwwwwww
w___..__.....__w
w........_...__w
w________..____w
w_2____2_0_2___w
w_2__2_____0_3_w
w_2_22__ww__03__
w_22__ww__w_3__w
w____w____w_3__w
w___w__00___0__w
w__w__011__03__w
w__w_0____w__3_w
w____1__1_w_0__w
w_ww_11_1_wwg0_w
w_wA____1___w__w
wwwwwwwwwwwwwwww
