wwwwwwwwwwwwwwww
w______.___11._w
w__33__0_____1_w
w____3w_w__0___w
w__33____ww33w_w
w_2_2___0.____3w
w___3_23____00_w
w_w___2_0_w__1.w
w__www_____ww__w
w____w__2__ww__w
w___w__g2__w_w3w
w_11_w___w___w1w
w__13_w____3___w
w_11__0www__00_w
w___A.....w____w
wwwwwwwwwwwwwwww
