wwwwwwwwwwwwwwww
w..__..__w_..__w
w...._._.._..3.w
w_0....3_.._...w
w_........2_...w
w__0......_w...w
w_.w.....g_.._.w
w.._......1....w
w..__..........w
w......._._w...w
w......_.......w
w_....._......2w
w_2._.._....3__w
w_.._.ww2....__w
w0..__.._ww.._Aw
wwwwwwwwwwwwwwww
