wwwwwwwwwwwwwwww
w2_21w_10_3..__w
w_._......__3__w
w____..w.___wwww
w____.w.._www.ww
w3__._w..__w___w
w3w_._w.__w__w.w
w3w.._....w_ww.w
w_w___w_.wg_.._w
w_w.._w_.w__..2w
wAw___w..w__..2w
w_w_____w__02__w
w_w____ww._22__w
w0_www_w22022__w
w0....._______1w
wwwwwwwwwwwwwwww
