wwwwwwwwwwwwwwww
w2_2_w__0_333g_w
w_..___0__3.3__w
w_..._wwwww___.w
w_00_.____w....w
w_00__w_w....2.w
w_ww3333ww..___w
w_w..___0.___1_w
w.w..__...__ww_w
www.._w..._ww__w
w_____w..._w___w
w.__1_wwwww.___w
w__w_______w___w
w_www____0__...w
w_w___A____....w
wwwwwwwwwwwwwwww
