wwwwwwwwwwwwwwww
w__________..._w
w_w.____.____1.w
w_.._..1_ww.___w
w__w_w._w..ww__w
w....._...____3w
w..w.._.ww_w__.w
w__.w.____ww_w_w
w_____g_._w____w
w.._.___..ww___w
w.._.w_w_ww_2._w
w._w_...__..3www
w2w_....._.____w
w_w_.2..1.3_A__w
w__._________3.w
wwwwwwwwwwwwwwww
