wwwwwwwwwwwwwwww
w____........_gw
w____.ww.....__w
w2...._3.......w
w....._0....1..w
wwww......____2w
w__w......3___1w
w__w.......www.w
w__ww..........w
w_____2........w
w_1___0.......2w
w............w_w
w............w_w
w___.....wwwww_w
w2w_.....3____Aw
wwwwwwwwwwwwwwww
