wwwwwwwwwwwwwwww
wg3333300302002w
w33333300221010w
w333333301113100
w33333330222211w
w33333300213330w
w333333w0120033w
w333330w3211211w
w33333301200210w
w33333031003000w
w13333301w20113w
w13333301020310w
w33w33301332213w
w33333302112110w
w33A33210130011w
wwwwwwwwwwwwwwww
