wwwwwwwwwwwwwwww
wwg._..._113___w
w_...00._...3_.w
w_30__0__w__2_ww
w_00__10..._22_w
w...._3_.11._..w
w._.21.__...1_.w
w..._3_._211.0_w
w_0._.._..23__.w
w_321.ww._..._.w
w_3.2_A_.2._w_.w
w_0.02_0..1_w_.w
w_33.3_.233._2.w
w2.0_..2_ww_...w
w___.ww..__.0._w
wwwwwwwwwwwwwwww
