wwwwwwwwwwwwwwww
wA_000.....__..w
w____.0....__g_w
w.___........._w
w.3__......ww._w
w..1_0....._w..w
w...1......_w..w
w........2__ww.w
w.........__ww.w
w...w.....__.www
w_.......3_3...w
w__......___...w
w__......__0...w
w_____2..__0...w
w1____0.____..2w
wwwwwwwwwwwwwwww
