wwwwwwwwwwwwwwww
w00___________gw
w00000_0w3333__w
w__33000w00333_w
w__110000w0__33w
w01200w10000_1_w
w02201w111w021_w
w0000w01_11212_w
w_100131_021_22w
w_12_1000332__2w
w_1210www03_122w
w_1211_2223112_w
w_111_12_223122w
w113133111_31_2w
wA1_33____331_2w
wwwwwwwwwwwwwwww
