wwwwwwwwwwwwwwww
wA___0_...w___gw
w_____0...www__w
w__10...www..w_w
w.......___..w_w
w.......___..w_w
w............w_w
w1...........w_w
w____0.........w
w.__0_w______..w
w.___0.._1__0.2w
w.ww__..___ww..w
w...__1.w_ww...w
w0.3__0.www....w
w...2_0..ww....w
wwwwwwwwwwwwwwww
