wwwwwwwwwwwwwwww
w2_2_w__0_3.._1w
w_........._3__w
w_......__w____w
w_......__w_.._w
w_0_...___w____w
w___...___w__..w
w_......_g__...w
w_.___w_____.._w
w__.._w__._w.._w
w__..ww...w_.._w
wwwww_w.._w0_._w
w_____w...ww__2w
w_________0_2.2w
wA____________1w
wwwwwwwwwwwwwwww
