wwwwwwwwwwwwwwww
w..._..0......3w
w..__0...__..__w
w.._..._.www___w
ww._._._.w02__gw
w_.__.wwww_____w
w_3_www_____.__w
w_ww___www._3_.w
w.__________.__w
w.w_..____..w__w
w_w...___..w.11w
w_....w._..3.21w
w_....w0.w2.w12w
w_...w.www_____w
w_._____3._A___w
wwwwwwwwwwwwwwww
