wwwwwwwwwwwwwwww
w....__________w
w......1.......w
w..............w
w_............_w
w_.......01..._w
w_......3_A0.._w
w.............2w
w_...0___3....1w
w_...wwwww.....w
w_....._w.____.w
w_....._w.__2_.w
w0....._w.____.w
ww.....3w.____.w
wg.......1____3w
wwwwwwwwwwwwwwww
