wwwwwwwwwwwwwwww
wA____0..1____gw
w______...www__w
w__10.......1w_w
w............w_w
w........3...w_w
w............w_w
w1...........w_w
w____0.........w
w.____.1__0__.2w
w.____.._0___..w
w.ww__..___ww..w
w...__1.w_ww...w
w0.3__0.www....w
w...2_0..ww....w
wwwwwwwwwwwwwwww
