wwwwwwwwwwwwwwww
w..w_1___..3__.w
w...___.3___A_.w
w.w1.3w.w10.w_.w
w0_.w..w....w11w
w_w0........w..w
w_w0...__1..w._w
w___._...._.w._w
w_ww.w..3....__w
w__1_ww....w...w
w_..........._ww
ww............_w
w.w._..._._._ww.
w.._.._....ww__w
w_._0....0.__gww
wwwwwwwwwwwwww..
