wwwwwwwwwwwwwwww
w....._g_111...w
w.........1....w
w......___1....w
w.....3_A__....w
w...._w___0....w
w.....w...._...w
w.._.._2.._._..w
w0...__.___.._.w
w2_ww_w.__w....w
w_____ww__..__.w
w_w___3__...._.w
w____.0........w
w___...........w
w000._.........w
wwwwwwwwwwwwwwww
