wwwwwwwwwwwwwwww
w___..2__1__0..w
w___..2______..w
w01wwwwwww___..w
w__w_.__.._1_w.w
w..wg._......_.w
w..w___...._._.w
w33w_.....___..w
w______..___A_.w
w.w.___.._____ww
w._._1_.._____3w
w2w.ww..w_w___ww
w2...0.._ww_._.w
w_..._______...w
w_...33___.....w
wwwwwwwwwwwwwwww
