wwwwwwwwwwwwwwww
w_____________3w
w__wwwwwww_ww__w
w_wA22220002211w
w_wwwwwwww11111w
w3_00003__121_0w
w__333310000_00w
w____3333__00__w
w_w_ww3_w__1w_.w
w_0_w_33__w_w_.w
w_00w_333_w_w__w
w_0_ww_____0_w_w
w_02wwgwwww0___w
w_0___w__w_00__w
w_3333333_____2w
wwwwwwwwwwwwwwww
