wwwwwwwwwwwwwwww
w____________11w
w_1____2_00_111w
w11ww0_____00__w
w1__ww_www_301_w
w____1_____w01_w
w_3w___111_w01__
w3_w__2221_wA1__
w3_w22_113_w_1_w
w3_ww3___w__10_w
w3__wwwwwwww11_w
w3_g__0000000_1w
w3_g__0_______1w
w33ww__w_www111w
w_33333________w
wwwwwwwwwwwwwwww
