wwwwwwwwwwwwwwww
w.0_.__.w_...__w
w__..._____.___w
w__.0.......1._w
w____..ww_.w...w
w__._.w_.__._..w
w..1__w...__._ww
w2___w...___3_ww
w__.w...__w..__w
wA_...0_._w.___w
www.______.w__.w
ww.__w_._3___2.w
w__.gw.w_.1_w__w
w__..__w..._...w
w__.2______....w
wwwwwwwwwwwwwwww
