wwwwwwwwwwwwwwww
w3333.w_...._w1w
w....._.....A_1w
w....._____..._w
w___..3____w.._w
w_1_..wwww__300w
w_....w...__.__w
w.....w..._____w
w0....w0.__.wwww
w__ww_w00...__gw
w________...___w
w.w_.1___..2___w
w..............w
w..............w
w..............w
wwwwwwwwwwwwwwww
