wwwwwwwwwwwwwwww
w._._1.__1..1__w
w___11___1_____w
w___1__..__1_._w
ww___1_._.3_.__w
w_g__......._A1w
w.......1...___w
w.._...........w
w._..ww.1w..._.w
w...w...1___._..
w........_._11.w
w...._..1..._._w
w..1_..1...1_11w
w.1_.__._._..__w
w____._________w
wwwwwwwwwwwwwwww
