wwwwwwwwwwwwwwww
w.w.._32.....__w
w.0..3..2.1..._w
w.w33w.3333..._w
w._....3.w..2._w
w3.111200.033._w
w0.._.2.3333.__w
w_.31_...22.3_3w
w_..1.30..2.._3w
w3.2_.....2.3_1w
w1....110..1._2w
w..22.....01032w
w.101..1...1..2w
w..13.2......._w
w..w.3_.3gw31.Aw
wwwwwwwwwwwwwwww
