wwwwwwwwwwwwwwww
w_________1____w
w__wwwwww_1____w
w__w___Awwwww__w
w_w____w2222w11w
w_w__1_w22_2w1_w
w_w__1_w__02w1__
w_w_w__w_0_2w1_w
w_w_w_3____2w_1w
w_w___333_3____w
w_w__033303_w0_w
w_w___00003__0_w
w_w_w________0_w
w_w_wwwww333w__w
wgw_22222___w__w
wwwwwwwwwwwwwwww
