wwwwwwwwwwwwwwww
w0..___....111_w
w_...__.___1___w
w_..._...0___..w
w___w__.._..__0w
w1_._w_._...._3w
w.__.w____..w._w
wwAwww_.w____.ww
w022..ww..0...1w
w..._.....1..w.w
w......._....w.w
w_..........gw.w
w.._.....www_w_.
w._.___..w...._w
w.._..2....._.ww
wwwwwwwwwwwwww..
