wwwwwwwwwwwwwwww
w______.___ww._w
w___w__0__1_w__w
w__3w3.._______w
w_g_w_._._w33w_w
w_2_00000.___33w
w__w_0000___w__w
w_wwwww_A__1ww.w
w____www___ww__w
w__3_1111__w___w
w_3_.______w_33w
w_1__ww__ww_33_w
w_._3______33__w
w__.1.333_1_.__w
w________3w_3_2w
wwwwwwwwwwwwwwww
