wwwwwwwwwwwwwwww
w___..._22_2_2.w
w0w_____22__...w
w_w_...w__.___1w
w_.__..w_w0.___w
w__....._w0_ww_w
w._....www__.__w
w......_www____w
w..__._ww_A__._w
w__111.______w_w
w_1111.wwww__w_w
w._11_w________w
w..__________www
w____33__w_w.w.w
w1_2_3_.._____gw
wwwwwwwwwwwwwwww
