wwwwwwwwwwwwwwww
w_0............w
wA0....w.w...w1w
w_0......www2__w
w_wwwww.....w.gw
w____0.._.3_w._w
w...1.._____w..w
w.......2.._w..w
w.........3_w..w
w_...w.___._.2_w
w___.w.___.__w_w
w___ww......_w_w
w_www......._w_w
w___.......3_._w
w___.......3___w
wwwwwwwwwwwwwwww
