wwwwwwwwwwwwwwww
wA____0....____w
w__2__..1...3__w
w_1..........3_w
w..........ww__w
wwwww....wwwww_w
wwwwwww..wwwwwww
w______..____3.w
w..____..____.3w
w..............w
wwwwwww........w
w.....w__....22w
w__...w__1...__w
w___..www...___w
wg___....3..0__w
wwwwwwwwwwwwwwww
