wwwwwwwwwwwwwwww
w_.._.._____._3w
w__w___........w
w.1_..w__.ww.._w
w.._.w__...Aw._w
w._w._..3______w
w........w.._._w
w_0.__..ww._.._w
w__.__ww.._..w_w
w._..w...._..__w
w_ww..__....3__w
w_._.__...w__w.w
w_0_.gw_..._...w
w..w.._._..ww.2w
w_.__0.__._..._w
wwwwwwwwwwwwwwww
