wwwwwwwwwwwwwwww
w..ww_g_......3w
w...w___.......w
w....www.._____w
wwwww.......___w
w____2......___w
w_1__0......_1.w
w..__..........w
w..ww....wwww..w
w.......1__ww..w
w2.3....1__ww..w
w........__w...w
w__22_...__.._2w
w____0....2..__w
w_A___.......__w
wwwwwwwwwwwwwwww
