wwwwwwwwwwwwwwww
w_1.._____..___w
w__..3_A_0..___w
w__.._____..___w
w12..__1_1...__w
w............__w
ww..www......__w
w_____0.....1..w
w______........w
w..............w
w......__......w
w_.....___..___w
w__.....ww.._w_w
w__2........_w_w
w____2......_wgw
wwwwwwwwwwwwwwww
