wwwwwwwwwwwwwwww
w_._..2..13_0._w
w__________....w
w0_w__w__...0.3w
ww_g_....__.0.3w
w.w___.wwwww_w.w
w____..w._____.w
w_www...____A__w
w_w__._w.__2__ww
w_.._.ww.______w
w_...w.222w____w
www.www22w__w._w
w_.__0w__w1_...w
w..__w__ww.w..1w
w___...w....11ww
wwwwwwwwwwwwwwww
