wwwwwwwwwwwwwwww
w_____wwwwg____w
w_____w__wwwww_w
w___0_w.___w___w
w.____w.__.w0__w
w.____._w_.w00_w
w.___.w_w_.w_0__
w_.___w___ww_03w
w__w__w____.__3w
w2____w_..____3w
w222_Aw_wwwww_3w
w___2__11______w
w__ww0_w_wwww__w
w____ww__1_1000w
w.__0___1_000__w
wwwwwwwwwwwwwwww
