wwwwwwwwwwwwwwww
w___g_.3..wwwwww
w.____...wwww..w
w._w__w..w_...3w
w__w__w2.3___..w
w__wwww..1___..w
www........__..w
w0......._www1.w
w..wwww.1_____2w
w....ww.._____.w
w....www.____3.w
w23...ww.__3..ww
w__0.....__..www
w___0.......2www
w_A__...2..wwwww
wwwwwwwwwwwwwwww
