wwwwwwwwwwwwwwww
w..._...__.3___w
ww_____.2_..3_.w
w_1_.1.._0_0.1.w
wg.___00_.._3._w
w.3..33_..2....w
w._.11__._2.3_.w
w..._3_._.0030_w
w_1__.__1..0_2.w
w_2....w.A_..2.w
w_.22___.___0_.w
w_.._.20__1.._.w
w_..3.....11.2.w
w..0.11__.._.2_w
w2__._...___0__w
wwwwwwwwwwwwwwww
