wwwwwwwwwwwwwwww
w....111_____..w
w___1_w________w
w._1__w_0_w____w
w_2_3_w0__w_1_.w
wg___ww0__w_0_.w
wwwww____w___0_w
w_______ww___._w
w__2___ww0_____w
w__2_ww___3____w
w2_2w___0000w_.w
w__2_2_00__0gw.w
w______0A______w
w____3w_w__2__1w
w_w_2_____0__..w
wwwwwwwwwwwwwwww
