wwwwwwwwwwwwwwww
w__03....___w__w
w_____._____w__w
w___w__.3_...._w
w0__w02__....._w
w..1..3___..._gw
w.......___..._w
w....3...___.w1w
w..........._w.w
w_....3..____w1w
wA__..._._..3w_w
w_._....__...w_w
w.__.._.._..w..w
w.2.._______w.1w
w.....____....3w
wwwwwwwwwwwwwwww
