wwwwwwwwwwwwwwww
w___..2..1__0._w
w___..2..______w
w01w__w__ww__._w
w..._.__.w_1_w_w
w.._1._._wwwwwgw
w..__11_..__.__w
w33___...._____w
w_A____..______w
w.w.____.___w__w
w._.000..__w__3w
w2w.wwwwwwww__ww
w2.__0.._ww_._.w
w__..__33___...w
w_...33___.....w
wwwwwwwwwwwwwwww
