wwwwwwwwwwwwwwww
w1__110g__1__2_w
w1A..300_.w311_w
www231.303._010w
w._11.3w_322_.0w
w__w1.1__2_22.3w
w_3313_.20_.03ww
w_2w1103121..33w
w.0..w2_311.020w
w23223113..0_.0w
w03.03.__00_2.2w
w.3_11_3ww.0232w
w_w_1w011w02333w
w_0020ww33..20_w
w.1__0.__.323..w
wwwwwwwwwwwwwwww
