wwwwwwwwwwwwwwww
w_33333333____.w
w_3wwwww33...g.w
w_3wwwww33w11_.w
w_111111w3311_.w
w.2www0000311_.w
w.22ww0000330_.w
w._32wwww3330_.w
w._2213333330_.w
w.2211233222211w
w.1111111122222w
w.22__222112222w
w.ww3___00w3_0.w
w.www33__001_0.w
w.......A___...w
wwwwwwwwwwwwwwww
