wwwwwwwwwwwwwwww
www___..w......w
w.......wwww...w
w............__w
w_......wwwwww1w
w0...__w.......w
w_..._3w.......w
w0...._w....w.ww
w_...0___2_Awwww
w_...www___..g_w
w_....____1....w
w_2..._..__....w
w_0..._......._w
w....._.21...._w
w1_2.._.3___.21w
wwwwwwwwwwwwwwww
