wwwwwwwwwwwwwwww
w_1____........w
w____g_.______3w
ww_____..0__.30w
w.__w_...__w3_0w
w._._w_.222_.__w
w.___w._____w_ww
w..w_w.._______w
w0....___.1....w
w_......_.1....w
w.w.....A......w
w_ww.........._w
w.www........__w
w._____.....__.w
w______.__.__w.w
wwwwwwwwwwwwwwww
