wwwwwwwwwwwwwwww
w..wwwwwwwwwwwww
w.3____ww.._g_ww
w.1___0....____w
w...........___w
w..ww2......__.w
w.3____.ww..__.w
w...___.ww.w__.w
w...._..ww.wwwww
w........0.....w
w...1..3__2_2..w
w......._A__...w
w.......___....w
w...2...10....2w
w..............w
wwwwwwwwwwwwwwww
