wwwwwwwwwwwwwwww
w_____........3w
w__11_.0....___w
w_..........___w
w.._w._A_..._..w
w..__._2__..wwww
ww....3_0_...__w
ww...._1__.____w
w.....____.____w
w.._...........w
w_.3____...ww..w
w_w______..ww..w
w_www..........w
w____0.1...___gw
w___0......__www
wwwwwwwwwwwwwwww
