wwwwwwwwwwwwwwww
w_0....__w_.___w
w_.w__.____._.3w
w_.3_ww..1.._..w
w1......_....w.w
w..........._w.w
w__.....3_w_.w_w
w_...w...w._.w_w
w__0_..._w..g._w
w.w._...___._..w
w.www.....___._w
w.....w2ww_._..w
w._..2__0.....1w
w_.__.__....2__w
w__22__A.._._2_w
wwwwwwwwwwwwwwww
