wwwwwwwwwwwwwwww
w112_2222321132w
w22221301002201w
w11112201002330w
w010_2310302212w
w133_1130311103w
w_213311_311130w
w10131111121111w
w313311211111g1w
w31111321111111w
w11111111121111w
w11131111111111w
w1A111111111111w
w11111111111111w
w11111111111111w
wwwwwwwwwwwwwwww
