wwwwwwwwwwwwwwww
w__11____1..w__w
w______0....w__w
w______0....w1_w
w.www....0...._w
w...ww___....3ww
w....w_g_w.....w
w....ww__w.32_3w
w2....wwww.____w
w_.........3___w
w_2........____w
w___2_.....3___w
w_____1...._1__w
w______......0_w
w_3____0....3_Aw
wwwwwwwwwwwwwwww
