wwwwwwwwwwwwwwww
w.w__1___g__..3w
w._.____._.._..w
w0.._...._1w_..w
w__.w..w...w_.1w
w_ww..w.2..w_..w
wA0.__..1w..w..w
ww...___...._.2w
w0.1.._.....__2w
w_.0_...._.w_..w
w___._.w_.._w.2w
w_._....3..___3w
w1wwwwwww.11_...
w._..._...__.._w
w........_..._3w
wwwwwwwwwwwwww..
