wwwwwwwwwwwwwwww
wgwww_32w1_3__ww
w_03022022103_ww
w_w33w12223_33ww
w___1w131w_323ww
w32_2____0123www
w0____20___2__ww
w___1_w___20__ww
w___1_31__w_2_ww
w31__101_2_2_1ww
w1_1_w20_w_3__ww
w1_11212___3__ww
w1w11031_10___ww
ww113w213w__A_ww
ww1ww32_3_w31_ww
wwwwwwwwwwwwwwww
