wwwwwwwwwwwwwwww
w..____________w
w.__2______www_w
w___2_wwwwww___w
w_A_2_w___g_33_w
w___2_wwww_3___w
w2222.w.ww.3____
w_.___w._ww330_w
w__w__w.__w.___w
w__.._w.._w.._3w
w_22.....wwww_3w
w___2__11_w..__w
w__wwwwwwwwww__w
w___000________w
w___0__0000____w
wwwwwwwwwwwwwwww
