wwwwwwwwwwwwwwww
w____0....__0__w
w_.......3_____w
w1........13.__w
w............__w
w............1_w
w_w...........ww
w_w............w
w_w............w
wgw.....3......w
www............w
w.............2w
w...........23_w
wwww....2..3___w
wA____0....____w
wwwwwwwwwwwwwwww
