wwwwwwwwwwwwwwww
w_..__2_____.._w
w__w.._1.2w__._w
w____.0..__.__Aw
w3._w...0._3..1w
w..01w.....3_..w
w...3_.._..0_0.w
w_._..__.33__..w
w_02.1w..3_w2..w
w.__..wg.3__w__w
w..1____.1___._w
w0.2w...www.w_0w
w_..._w......_.w
w_3_.2.00_0.0._w
w_._.___.._3___w
wwwwwwwwwwwwwwww
