wwwwwwwwwwwwwwww
w..1____w_.....w
w_.__0____3._w.w
w_.._......._www
w__.w.www_ww_.ww
wgww_2______w_.w
w.w_0__.1._1__ww
w._0___.__.___ww
w.___3_.__._wwAw
w._w__0_.2w.___w
w.w_ww___w.__..w
w2___w_._ww_._.w
w_____w2ww_____w
w__.0..__w.._._w
w____..__..__3.w
wwwwwwwwwwwwwwww
