wwwwwwwwwwwwwwww
w___________3__w
w__www1wwwwA3__w
w_0w0______w_3_w
w__w_____2__w31w
w13w_22_____w__w
w13w____0___w___
w1.w__3_23__w13w
w1_w___0_2__w13w
w__w__0___2_w_3w
w_____0_____w_3w
w_gw_0_11_0_w33w
w__w_020_0__w33w
wwww02__1131w_3w
w.._0___1__1___w
wwwwwwwwwwwwwwww
