wwwwwwwwwwwwwwww
w_____1_w...3_Aw
w__1....w...2__w
w............__w
w............._w
w....w........1w
w....w_.g......w
w..www_._......w
w..www_._......w
w....w___...1.3w
w....ww........w
w..............w
w2.............w
w_0.2......2__ww
w___......3____w
wwwwwwwwwwwwwwww
