wwwwwwwwwwwwwwww
w________111...w
w._.11_.__1..2_w
w._..._.._1..._w
w........__w.._w
w__.__..._0w.__w
w_.........ww_ww
w.._......0.___w
w0........_....w
w__ww.....w.___w
w_A__.......___w
w_w_........___w
w2___.......__3w
w___........__.w
w000._......g_.w
wwwwwwwwwwwwwwww
