wwwwwwwwwwwwwwww
w____....____._w
w_..______1____w
w___3ww_____g__w
w_3_w_____w__2_w
w_.3______w___2w
w_._3_22__w__2_w
w_.w_____2www._w
w_.._0_0____w__w
w____0__0___w_.w
w__w__w_A_0__3_w
w___2__www_.___w
w_113__0__.____w
w___11_3...__3_w
w_..________0__w
wwwwwwwwwwwwwwww
