wwwwwwwwwwwwwwww
wg_.......3__..w
w__..0....___w.w
w_........___w.w
w1...2......_w_w
w...0_.......w_w
w...w_....3..0_w
w...w___......_w
w...ww0___...2ww
w......w___....w
w......ww......w
w..............w
w2.............w
w____1.........w
wA___0....2....w
wwwwwwwwwwwwwwww
