wwwwwwwwwwwwwwww
w.w___1_1____._w
w.__1_0________w
w0_._.0___1w_..w
wg__._0w...._._w
w._.._0__.ww0._w
w.__.____w.._..w
w__.___..w..._.w
w.__w_w....._._w
w_....3w._.__..w
w_._...w_..w_..w
w0.2w.....__w..w
w_w.ww_w1_A.....
w.....2..._....w
w___0_3__2.....w
wwwwwwwwwwwwww..
