wwwwwwwwwwwwwwww
w_._...2223_0._w
w__....22_www__w
w_w....__...___w
wAw.....___._._w
w_ww__.___ww_w_w
w_w_____w______w
w_www___w__g___w
w_w_0.__w_____ww
w_0.__w_w_...__w
w___.ww_w_...__w
ww__w_www_...._w
w00_0_____..._.w
w_______ww_111_w
w_11_.w_.__111ww
wwwwwwwwwwwwwwww
