wwwwwwwwwwwwwwww
w_33333333g___.w
w.3_22222211__.w
w.322w...2221_.w
w_1__1.333321_.w
w.2_30wwww331_.w
w.220w1.___311.w
w.__0w_3333..1.w
w._.3w000000.1.w
w.2.31w3._20.1_w
w.1_33ww..20.1_w
w.0__3ww333011_w
w._00ww110001__w
w__ww00000____.w
w.__A_________.w
wwwwwwwwwwwwwwww
