wwwwwwwwwwwwwwww
w0__...1_1..___w
w3333_.___.____w
w3.....1____g__w
w__..__1_.1___3w
w_._._2__._..__w
w._..._._220__0w
w._____2_...._.w
w_..w2.22__..._w
w.._2_22___..0_.
w..___.222w_.w_w
w..__21111__.._w
w_.._.1__100___w
w_ww_1_A_0._.._w
w___._22_22_.._w
wwwwwwwwwwwwwwww
