wwwwwwwwwwwwwwww
w__........_g_.w
w_.._22_____.__w
w_.__2_2.2...__w
w_....33.._2222w
w__.1.1.3.00.22w
w._1133130.0w2.w
w.w1.302122221.w
w.10.2233022.1.w
w_w02w333_22_11w
w_1_03.3332__w1w
w_0203331322_w1w
w_12..3_122.11_w
w_12221122.11_.w
wA__..111112___w
wwwwwwwwwwwwwwww
