wwwwwwwwwwwwwwww
wg_..w___..3ww.w
w___..3....__..w
ww__......w___.w
w.w_...ww.w___3w
w.....__w...__.w
w2...3___0....2w
ww....w___0....w
ww2......1.....w
ww___..........w
www__.3..0...2.w
w..._.......2_.w
w.....22...___.w
w1...3__0..____w
w...w___..3___Aw
wwwwwwwwwwwwwwww
