wwwwwwwwwwwwwwww
w___..2__1__0..w
w___..2______..w
w010.____w___..w
w____.__.._1_w.w
w..__._......_.w
w..____......_.w
w33__....._A_..w
wwww___..2____.w
w.w.___.._1ww_ww
w.w._1_..2_.w_3w
w0w.ww..w.w___ww
w.___0.._ww___.w
ww_____________w
w..._g_000...__w
wwwwwwwwwwwwwwww
