wwwwwwwwwwwwwwww
w..w_1___..3._.w
w...___.3__....w
ww........0.w..w
www.w..w....w11w
w.ww........w.ww
w0w....__1..w.gw
w__......._.w._w
w_...w..3....__w
w..._w.....w...w
w_22........._2w
wA__.w........3w
w11_ww.._._._w_.
w....._....ww__w
w00_.....0.___ww
wwwwwwwwwwwwww..
