wwwwwwwwwwwwwwww
w..__1__A......w
w._.____._.....w
w0......._1ww..w
w__.w..w...ww11w
w_ww..w.2..ww..w
w_...3...w..w..w
ww...w__...._._w
w...w._......w_w
w.w.gw..._.w.w.w
w..._..w_...w_2w
w0._.......w._3w
w_..._www._._w_.
w_0..._....ww__w
w___1...._____3w
wwwwwwwwwwwwww..
