wwwwwwwwwwwwwwww
wgww_......3___w
w____.....0____w
www.w..........w
w..............w
w...2....32....w
w__......____www
w_____..0.___www
w_____.3.......w
w..............w
w..............w
w......22......w
w.....w__......w
w2__..w__...3__w
wA_0...__...___w
wwwwwwwwwwwwwwww
