wwwwwwwwwwwwwwww
wA_..ww....3wwww
w_0....______www
w1_..ww._____www
w.....w.101ww__w
w..........w___w
w.www..www0.___w
w____0.www.._11w
w____..www.....w
w_ww_..........w
w_ww_.....22___w
w_ww_.w.3______w
w_ww_.w.______.w
w_ww_2w.____ww.w
wgww_.w.3__ww..w
wwwwwwwwwwwwwwww
