wwwwwwwwwwwwwwww
w_.____._______w
w____2..___0___w
w_33___w__0..__w
wA3_ww____..w_2w
w______2____w__w
w_w__wwwwww_w__w
w_1_ww____w_w__w
w____w___0__111w
w__000__100___2w
w_______130_3__w
wwwwww_______2_w
w.....w.__0____w
w_322__0___11__w
wg3____________w
wwwwwwwwwwwwwwww
