wwwwwwwwwwwwwwww
w__.......3_1_.w
wg.._..3_3211__w
w..223223.w221_w
w..2w23w2._2w11w
w.2w2.103222w3.w
w.21233100.022.w
w.2w2303122.23.w
w.00.223333200.w
w23w.w113A23.01w
w_3_01.3100_.01w
w2300333w32.301w
w2.w..301.3030.w
w2.w200331.100.w
w222.0..3112___w
wwwwwwwwwwwwwwww
