wwwwwwwwwwwwwwww
w_.____._______w
w_.___..__00___w
w_.111ww__0..__w
w__www____..___w
w_1_3_00_______w
w_1_3_0_22__w__w
w_1______wwgw__w
w___ww_____ww__w
w________3_w___w
w____2__33_33__w
w__w_2__3__3___w
w_A2__.________w
w__22_...__11__w
w______________w
wwwwwwwwwwwwwwww
