wwwwwwwwwwwwwwww
w..............w
w....11w__.....w
w....____2_____w
w_...__wwwwwww1w
w0...__w_..____w
w_..._3w...g___w
w0...._w...____w
w_...0_w......1w
w_...wwwww.....w
w_....__w......w
w_2...___......w
wA_...._w......w
w_0....3w......w
w0_........_2_3w
wwwwwwwwwwwwwwww
