wwwwwwwwwwwwwwww
w.....w_...._w1w
w....._.....__3w
w....._____..._w
w___.._____w.._w
w___.._www__300w
w_....3...__.__w
w........._._g_w
w0.......__.wwww
w__.........___w
w12_........___w
w___.......2___w
w_......3......w
w_....___......w
w_....A___.....w
wwwwwwwwwwwwwwww
