wwwwwwwwwwwwwwww
w___g_....wwwwww
w.____...wwww..w
w._w__w..w_...3w
w__w__w...___..w
w__ww.w...___..w
w_........3__..w
w0..2...3_www1.w
w..wwww.1_____2w
w....ww.._____.w
w....www.____3.w
w23...ww.__3..ww
w__0.....__..www
w___0.......2www
w_A__...2..wwwww
wwwwwwwwwwwwwwww
