wwwwwwwwwwwwwwww
w_____w11_____gw
w333___www_0w__w
w___3_____00___w
w___wwwww_0_w__w
w3_wA______w__1w
w3__2._0________
w__w___0___w_0_w
w_ww_110__w____w
w___._0_._w____w
w_____000_w___3w
w___2______w_22w
w3__ww___w_2___w
w_____ww_____2_w
w___0...._2____w
wwwwwwwwwwwwwwww
