wwwwwwwwwwwwwwww
w_000000000000_w
w00_ww_3333330_w
w__w1333___2_30w
w_ww1wwwwwww_3_w
w3w..w_3___ww30w
w3w..w__000_w__w
w3w22wA3__00w_1w
w3w2_wwwww_0w_1w
w3w22_3www00w_1w
w3w___33300_w11w
w3w_w__000_ww1_w
w3w__ww__www_1_w
w3ww__wwww_111_w
w_gw_______11_2w
wwwwwwwwwwwwwwww
