wwwwwwwwwwwwwwww
w__0.....1w____w
w__0..ww..w__..w
w1_w___w..wg_..w
w..____w.......w
w.2_____0......w
w........0....2w
w0......wwww...w
wwww....w____..w
w____...w____www
w_____..ww.....w
w....1.....2...w
w20.......__ww.w
w___.0.2..___www
wA_0...w._____ww
wwwwwwwwwwwwwwww
