wwwwwwwwwwwwwwww
w___1........3_w
w...._0__....._w
w....__A_......w
w2...____......w
w_..._0_.....1_w
w_.w...........w
wg__0...__.....w
www__...___....w
w_......___ww..w
w_w_....____0..w
w__2....___....w
w_w............w
w_ww0....___...w
w_.0_...._3____w
wwwwwwwwwwwwwwww
