wwwwwwwwwwwwwwww
w_..__.__._g...w
w_1.1______1...w
w____.0_1.1....w
w0_.._1._......w
w.___..........w
w__0_..........w
w_..2......__3.w
w__0_......2_.2w
w1_1_.....2._3_w
w1.......3___._w
w.......0._.__3w
w......2_.__3__w
w.....2_0._..__w
w....0_A_1_._._w
wwwwwwwwwwwwwwww
