wwwwwwwwwwwwwwww
w.___.__wA.....w
w_w___..______1w
w_..__..3_www__w
w_.wwww__.._w__w
w1._.w_...._ww_w
w._____1.._w_w_w
w__.__g______w_w
w_1._._.._...w_w
w_...w__._..__3w
w_._..__._.3___w
w....__...__..ww
w.w_._.._..__3_w
w_02__.......__w
w__.._....2___.w
wwwwwwwwwwwwwwww
