wwwwwwwwwwwwwwww
w______________w
w_w_w_2_2200w__w
w__3w__...._w__w
w_33_w_....____w
w_____wwwwww000w
w_._11_00__ww__w
w_.__1A1_______w
w__ww_1__2__w__w
w_2w_3____w__3_w
w11_w_30_33w_3_w
w1__w__333_w_3_w
w1___w____3w.__w
w__11gww___w__1w
w______________w
wwwwwwwwwwwwwwww
