wwwwwwwwwwwwwwww
w...1....3____Aw
wwww.1....3____w
w____.......___w
w____w......._1w
w12_wwww.......w
w..wwwwwwww....w
w.0....___w....w
w......___w....w
ww....._g_w....w
ww.....wwww..3_w
w............__w
w_2..........__w
w__..__......3_w
w______2.www.0_w
wwwwwwwwwwwwwwww
