wwwwwwwwwwwwwwww
w0..___....3__.w
w_..___.3_____.w
w_._._w.w10.w_.w
w__.........w__w
w__.........w..w
w_._...__1..w._w
wg..._.A.._.w._w
w_._.w..3....._w
w___.ww....w...w
w_............3w
w............._w
w..........._3_.
w._____.....32_w
w_.._....0.__._w
wwwwwwwwwwwwww..
