wwwwwwwwwwwwwwww
w....__1_____..w
w....________..w
w2...____......w
w_...3__.......w
w_...__2....2_Aw
w_........1.3__w
w_0.1.......1_.w
w.....___......w
w.....___......w
ww....__...w...w
w_..3......w..ww
w_.............w
w_.......______w
w0......._..._gw
wwwwwwwwwwwwwwww
