wwwwwwwwwwwwwwww
w__0..__...___gw
w__0.w.________w
w..............w
w.......2......w
w.w....___2....w
w2....3____....w
w......1____...w
w.2.....____w..w
w__.....1___w..w
wA___0....__w..w
w_____.........w
w2.3__1........w
w............__w
w.....0......__w
wwwwwwwwwwwwwwww
