wwwwwwwwwwwwwwww
w_._..2..1__0._w
w_....2..______w
w0ww__w__ww__._w
w.w__._ww__1___w
w.w____w_ww_w__w
w.______w___.2_w
w_w_A__.w.___2_w
w_w____.w__22__w
w_w.00__.___w__w
w_w.000..__w___w
w_wwwwwwww__w__w
w..._0..__w_w__w
w....__3___w.__w
w....wwwgw____.w
wwwwwwwwwwwwwwww
