wwwwwwwwwwwwwwww
w._._..0......0w
w____0_..__.3__w
w__0_.__.___.._w
ww__2__.____.__w
w___.....__A___w
w_..._...._____w
w_1....w_.__...w
w_...ww..w_.._.w
w_..w.....ww._.w
w1.._.._.www...w
w_....w__..._._w
w_._._.._w.__._w
w__..._.___..__w
w_0...._g______w
wwwwwwwwwwwwwwww
