wwwwwwwwwwwwwwww
w_311__1_333___w
w_3__1333_333_3w
w1_0003_wwww3__w
w001103_w_ww_31w
w____1_3___wAw_w
wwwww2113ww..w_w
w__gwwwww1wwww_w
w____w___0_www_w
w____w_33____w_w
w______3w_33_w3w
w100300___w_3w_w
w10030001w_1111w
w113000__w33311w
w_1__10__w__311w
wwwwwwwwwwwwwwww
