wwwwwwwwwwwwwwww
w....__.__..__gw
w.w__.__...___.w
www__.._3...w_.w
w__w1.www.www..w
w__..___.____..w
w_0.____..__._ww
w_____...._._2ww
w_www.w......._w
w__...w........w
w__...w___..ww.w
w....2_w....w..w
w2____ww__..w__w
w__...www_....ww
w__._A___3_....w
wwwwwwwwwwwwwwww
