wwwwwwwwwwwwwwww
w_..___....111_w
w_...__.___1___w
w_...__..0__.30w
wg__w_...__w3_0w
w._._w_.222_.__w
w.___w._w___w__w
w..w_w..w______w
w0....www.1_.._w
w_......_.1_..2w
w.w....._.....2w
w_ww........_._w
w.www........__w
w.0A___.....___w
w0___22.__.___.w
wwwwwwwwwwwwwwww
