wwwwwwwwwwwwwwww
w..__________..w
w.__2__000____.w
w__2___2__003__w
w__2000020000__w
w___03033223_0_w
w___3022223320_w
w__2032112202__w
w__3032g122300_w
w0_3132212303__w
w__330133330___w
w__303020300___w
w___0320023____w
w.___0_0____0__w
w..__________.Aw
wwwwwwwwwwwwwwww
