wwwwwwwwwwwwwwww
w___3....2.1..Aw
w_2_w_..__...._w
w___w__.3_3..1_w
w0..w.2______1_w
w__ww.3________w
w1...wwwwww.2._w
w....___.____w1w
w0..1___.00__w.w
w...._w_...__w1w
w___www_....3w_w
wwww_____2...w_w
w______.....w..w
w___...0.1.ww.1w
w__g....w2....3w
wwwwwwwwwwwwwwww
