wwwwwwwwwwwwwwww
w_0100000______w
w__0___33031__0w
w0____22_2_2110w
w0_2wwwwwww__01w
w__ww__00gw__11w
w_1w_2__000w21_w
w1_w2____03w_1_w
w1_w__2__0_w21_w
w__w_12_011w1_2w
w_ww__200_w_1_2w
w1__222_www3_w_w
w___10_wwwA_2w_w
w__21__11_www__w
w____1___1_3___w
wwwwwwwwwwwwwwww
