wwwwwwwwwwwwwwww
w_.3._1.w.www__w
w_....._..ww__.w
wA....__.www_1_w
w0....__._ww__1w
w....__1____1_.w
w...www........w
w......__..w...w
ww_1_3___._....w
w1...__w_.w..w.w
w_...3__0.w....w
w.....w.._w....w
w.........w.._2w
w......wg_...3_w
w0......__...3_w
wwwwwwwwwwwwwwww
