wwwwwwwwwwwwwwww
w.0w11_2__133_.w
w___1_20222___.w
w.._11..3__023_w
w._1_3_1_.30.3_w
w_23_g1_313_3_0w
w.2__3_wwww0_1_w
w_210ww11._www0w
w__ww1_10_012w2w
ww___1_1__.2_w0w
w033_2___2__3w2w
w0_.333._1.302_w
w0_____033333__w
w.2_3_10_02210_w
w22_3..2__1_A._w
wwwwwwwwwwwwwwww
