wwwwwwwwwwwwwwww
w__________..._w
w_w._1__.1____.w
w_.._..________w
w__w_w1_w..ww__w
w....._...____3w
w2.w.._.ww.w_..w
w__.w.____ww_w_w
w____.__._w__._w
w..0._....ww__gw
w0._.w_w_.w_.__w
w0.w_..._..._.ww
w___2...._..___w
w_.0_..._____..w
w_A.__.....__3.w
wwwwwwwwwwwwwwww
