wwwwwwwwwwwwwwww
w___33____2_222w
w__00000032_Aw_w
w2w__w1_00201__w
w2www1_0__2wwwww
w2w__22w_03__www
w2w_0__2__00wwgw
w_w2202__0030w0w
w_w__0_22____w0w
w_www_2_0w_0w_3w
w_0____w__ww_20w
w_2__ww22__00_0w
w___w_w221ww023w
w322w0_2_00222_w
w____2__0000223w
wwwwwwwwwwwwwwww
