wwwwwwwwwwwwwwww
w__3333003_0002w
wA___2___201010w
w000w_21__0__3_w
w3_2ww30w02_031w
w_00103___01_w0w
w_32_0w_00__ww3w
w320_www0230123w
w300331_1030w3ww
w32_10_3_00_210w
w12w_w_01w3_w13w
w002w1_0g321100w
w___0310_00w__3w
w_3___0_2_02__0w
w3__3_210130__1w
wwwwwwwwwwwwwwww
