wwwwwwwwwwwwwwww
w..__________..w
w.._2__000___g.w
w__2___2__003__w
w0_2000020000__w
w01_03033223_03w
w01130....33203w
w0_203.ww.20213w
w__303.ww.23003w
w0_313.ww.303_3w
w__330....30__2w
w__303020300_22w
w___0320023____w
w..__0_0____0_.w
w..A_____222...w
wwwwwwwwwwwwwwww
