wwwwwwwwwwwwwwww
w_.............w
w_.....w......3w
w_...........3_w
w_wwwww2....w._w
w_______0.._w.Aw
w...1..www1_w..w
w.........._w..w
w.........._w..w
w_.....320.0.._w
wgw_...___..3w_w
w_w_1.._._.._w_w
w_w_..._._.._w_w
w_._..._._.._._w
w___...___..___w
wwwwwwwwwwwwwwww
