wwwwwwwwwwwwwwww
w___1........__w
w............_Aw
w............3_w
w2...........__w
w_............3w
w_.............w
w___0..._w.....w
wwww_..._w.....w
w_......_wwww..w
w_w_....3wg_0..w
w_w0.....w.....w
w_w............w
w_ww0....___...w
w_.0_...._2____w
wwwwwwwwwwwwwwww
