wwwwwwwwwwwwwwww
wA_______111...w
w...11____1....w
w.....____1....w
w.....3____w...w
w...._w___0w...w
w.....w....wwwww
w.._.._2.._.___w
w0...__.0__.___w
w2_ww_w.__w.__.w
w_____ww0_..__.w
w_w___3__...__.w
wg___.0.....__3w
w___........__.w
w000._......__.w
wwwwwwwwwwwwwwww
