wwwwwwwwwwwwwwww
w__...11______.w
w............__w
w__.w.._ww..1..w
w...w._0_www...w
w...w.__.......w
w.www.___.ww2_1w
w_1..._w....._.w
wg___.3.w___3__w
w.....ww...3A_.w
w.www.w....._..w
ww....__.w..w..w
w_..ww_..wwww__w
w..._.___._w...w
w..._..........w
wwwwwwwwwwwwwwww
