wwwwwwwwwwwwwwww
w_000030000__3_w
w_wwwwwww______w
www___1__2_1_2_w
www__w___w33_2_w
wAw_2______332_w
w_w22_2wwww_33_w
w_w2__w_____233w
w_w2__w_0002333w
w__2___w00003__w
w222_3__w00__3ww
w2_w2__ww__3___w
w2_w3_ww_w___www
w2_23_333_wwwwgw
w___0000033333_w
wwwwwwwwwwwwwwww
