wwwwwwwwwwwwwwww
w____2_________w
w__222___wwww33w
w_222_w_33__w3_w
w_22__w13_3333_w
w_2___w_3w0_3__w
wA_www____003__w
w__w___2___0w_1w
www____2___0ww1w
ww______2200000w
ww_wwww__22ww01w
wg__1_w___2_w01w
w_1111_w_w__w01w
w_13333______01w
w_____33__33331w
wwwwwwwwwwwwwwww
