wwwwwwwwwwwwwwww
w_..._..333_1__w
w__..._...___1_w
w____.33_3_11_Aw
w.____3_.33____w
w___.._._.._31_w
w__..3__3__w11_w
w0.03_..3ww3.._w
w_._....3w3..._w
w._.3.3.ww_..__.
w._...._1ww_.._w
w.__.._.._...._w
w_..1_ww.w._.__w
w____1w._.__.._w
w___.___wwwwg__w
wwwwwwwwwwwwwwww
