wwwwwwwwwwwwwwww
w....__...0..__w
w_w..._____..__w
w__......_3.._gw
w...........w__w
w...w.....__w__w
w.2__w22..._.._w
w.___w__.3.....w
w..............w
w........2__...w
w........___2..w
w..........__0.w
w...20.....__w.w
w.____......3w.w
w__A__.........w
wwwwwwwwwwwwwwww
