wwwwwwwwwwwwwwww
w_311__1_333___w
w_A_33333_33__3w
w__2322232222__w
w0_230__w___2_1w
w__2_1_3___22w_w
ww_w22_13w_22w_w
ww__2wwww_3333_w
w_w___3w_3_w2__w
w_w__111111___2w
w_ww3113333_222w
w100_1w___w32w_w
w___10_w1w_w211w
w_g11__w___3311w
w____1ww___3311w
wwwwwwwwwwwwwwww
