wwwwwwwwwwwwwwww
w3w_www22ww_wAww
ww3_3w_www0_0_ww
ww30_1_w2ww1_3ww
www2_www32_13w_w
ww_2_w1132w2_0_w
ww2w3ww0ww____ww
w0_20__0ww_3_www
ww32w__w_3ww__0w
w1w_w022_3_w__0w
ww3_____w3w__w0w
w_w__2_3ww22_w0w
ww30w3__3_w030ww
ww01__221w____ww
wg_w00ww0_0www2w
wwwwwwwwwwwwwwww
