wwwwwwwwwwwwwwww
w___ww._2__2_2.w
w0w_________1..w
w_w_....__..__1w
w_.__.___w_____w
w__..._._w__.w_w
w.__.._ww___.__w
w..._..__w__.__w
w._____w_.._.._w
wwA121w______w_w
wwwww.wwwww..__w
w__w__w________w
w__w____......gw
w__w_3.._w_..._w
w____3_.....0._w
wwwwwwwwwwwwwwww
