wwwwwwwwwwwwwwww
w______________w
w____wwwwww____w
w___w_____ww3__w
w__ww___A_3w2_3w
w33___1___ww2_3w
w__3111__ww22_3_
w___33___w_2___w
w__w_____wg__www
w__wwwwwwwwwww_w
w_______2______w
w__333__.._0___w
w13_23_2.__000_w
w1______0000___w
w_1____________w
wwwwwwwwwwwwwwww
