wwwwwwwwwwwwwwww
wA____0....____w
w______....1___w
w__.1.......1__w
w__..........._w
w_0....ww.....1w
w......__......w
w.....w__.....3w
w.....ww1......w
w...........3..w
www............w
wg_w....._.....w
w__w..ww__.....w
w___ww____.....w
w.._______.....w
wwwwwwwwwwwwwwww
