wwwwwwwwwwwwwwww
w__0__...___...w
wg_w________..1w
w_ww.._.____...w
w0_wwww..www.._w
w........w.._2_w
w....ww..w0_2__w
w___..w...0____w
w__0_.w..._____w
w....w___.._.32w
w....____....__w
w...2_____...__w
w......1.w...__w
w..__....w..0__w
w2.__..3.wA____w
wwwwwwwwwwwwwwww
