wwwwwwwwwwwwwwww
w_.._11_.__.3__w
w__w.._....2__0w
w1..3.._1ww._._w
w.._.ww.....12_w
w..33_...._1w..w
w..2w2230w.._..w
w_22..3311.__..w
w__.._.w..2.w..w
w2_0.w...0__._2w
w2....._..A1w__w
w..ww1.3..w.ww.w
w_._.1_.....w..w
w.011w..ww.._3_w
w____gww..333..w
wwwwwwwwwwwwwwww
