wwwwwwwwwwwwwwww
w__11__________w
w_0111111111111w
w10ww011______1w
w10_ww1_wwww_11w
w_00_w1____ww1_w
w_00_w_1000_w___
w30___311000w___
wA_02w3010__w_2w
ww_0_w3_____w_2w
wgw00wwwwwwww12w
w_w____w___22_2w
w_www_11122_222w
w11__www11___22w
w_11111111_____w
wwwwwwwwwwwwwwww
