wwwwwwwwwwwwwwwwwwwwwwwwww
w.oo.....ooo..o......A...w
w.x..wow...x..-...oo...www
w.x..wxw......-...xx...oow
w.x..w.w-.-...-.wwwwww.xxw
w.x..w.w...oo.-........xxw
w.......xx.xx.-....oww...w
w.ooo..www....-....x.....w
w.xxx..-......ww...x-.-..w
w..w...--.....xx...x.....w
w..w.....wwwoo...........w
w....xx.....xx......e....w
wwwwwwwwwwwwwwwwwwwwwwwwww