wwwwwwwwwwwwwwww
wwwwwg___...0..w
w.www_____.....w
w.w.0...___w2..w
w.ww....__ww2..w
w1...w...ww__..w
w_3..ww0...___3w
w__...www..___.w
w___2...ww.0___w
w.___....ww.._3w
w.1___....w..2.w
w..____2.......w
w..1_____0.2ww.w
w...0____0_..w.w
w...2_____A_..ww
wwwwwwwwwwwwwwww
