wwwwwwwwwwwwwwww
w....._0...__w_w
w0__..__..___wgw
w___.._w..._1w_w
w.__..__.......w
w.__.....__.0.2w
w.__3....wwwwwww
w........._____w
w.....w__..3___w
w.....w2_......w
w..22..........w
w..__w.........w
w.___ww.3___2..w
w____ww..3___..w
w____......3A..w
wwwwwwwwwwwwwwww
