wwwwwwwwwwwwwwww
wg...0222___2_0w
www..w333..._www
w1w11wwww2___..w
w______3_._...0w
w_w22__3_.__3.0w
w3__1__3_._...0w
w_ww.__3_.___.0w
w2...0_3_.3._.0w
w1_1.0_3_..._.0w
w_...0_3_____.0w
w_...0_3_.0.0.0w
w1...0_.1wwww.0w
w_...0_________w
wA.000.0.0.0.00w
wwwwwwwwwwwwwwww
