wwwwwwwwwwwwwwww
w...1...3...__Aw
w...........3__w
w.0..ww..w..___w
w1__.........1.w
w.___www2......w
w..__w___2.....w
w...ww____..3..w
w1....3____....w
w.....3_wwww...w
w......1.w__2..w
ww........___0_w
w___........___w
w_w_........3..w
wgw_w..3.......w
wwwwwwwwwwwwwwww
