wwwwwwwwwwwwwwww
w....w......3_ww
w...1_0.....__ww
w....__0....._.w
w............1.w
w____.....__w..w
w0___.....__w..w
w.._w.....__w..w
w.........__...w
w.w......._g...w
w._2w22...ww...w
w.._w__...3....w
w_2.......__...w
w__.......___..w
wA__0......____w
wwwwwwwwwwwwwwww
