wwwwwwwwwwwwwwww
wA______.._0...w
www.010_..__w..w
w.........__w..w
w........._1w..w
w..............w
w______....w...w
w_____0...__w..w
w_wwww....__w..w
www.......__...w
w.........11...w
w..............w
w..........w...w
w.........._wwww
w.......w_____gw
wwwwwwwwwwwwwwww
