wwwwwwwwwwwwwwww
w_1_000....___gw
w____2_....wwwww
w__..........3.w
w..............w
w..............w
w__3_________22w
w______________w
w......____wwwww
w......___ww.._w
w......___w...2w
w......___w1.3_w
ww..........___w
w002....2..3___w
w____......3__Aw
wwwwwwwwwwwwwwww
