wwwwwwwwwwwwwwww
wg_____.....3__w
w_____...0..__ww
ww......0...wwww
w.___..........w
w.___.....www..w
w..w_.3_22w__..w
w......______..w
w..............w
w.0......_w_2_.w
w._0....._____.w
w.__.......w...w
w.3__........2.w
w..__....._23__w
w..w_.....3___Aw
wwwwwwwwwwwwwwww
