wwwwwwwwwwwwwwww
w......0..___www
w..........____w
wwww.........__w
w____..2.....__w
w.______....___w
w...........1_.w
w............1.w
w.......www....w
w2...3____w....w
w......___w.0.1w
w_1.....__w....w
w__0....._w..w.w
w__0....._.1.__w
wA___0......w_gw
wwwwwwwwwwwwwwww
