wwwwwwwwwwwwwwww
w__.3.________1w
w__..0____ww...w
wwww....www.__gw
w.__2.......3__w
w.___2......__ww
w.......1.3.__ww
w_.....3_..._1ww
w__2..w__......w
w1....wwww2_...w
w........w__3..w
w.w___.........w
w.w11...30..__ww
w.......__..2_.w
w......._A.....w
wwwwwwwwwwwwwwww
