wwwwwwwwwwwwwwww
w_____0....___gw
w______w...wwwww
w30..www.......w
w..............w
www.ww...wwwwwww
w__2__2______0_w
w__________0___w
w....ww____wwwww
w.....w__3w...3w
w......___w..._w
w......121w..._w
w............._w
w_2_........22_w
wA__0.......___w
wwwwwwwwwwwwwwww
