wwwwwwwwwwwwwwww
w0_..._.0..___gw
w______....w___w
w..........ww__w
w..........ww..w
wwww.......ww..w
w___.......w__3w
w__0.......w___w
w__.....2...3__w
w__..........0_w
w__............w
w1.............w
w...........__2w
w.2.2......1___w
w____......3__Aw
wwwwwwwwwwwwwwww
