wwwwwwwwwwwwwwww
wce....c......fw
w..............w
w..............w
w...........c..w
w..............w
wc.............w
w...........c..w
w..............w
w..............w
w....c.........w
wxA.........c._w
wix..c.c....._cw
wwwwwwwwwwwwwwww
