wwwwwwwwwwwwwwww
wi...........ccw
www.c..ttt.....w
w.w.........c..w
w.w...t._x_....w
w.ww..t._c_....w
w......._c_....w
w....c.._x_....w
w.........www..w
w..t.....wwfww.w
w..tc....w.c...w
wA.tt..c.w.....w
we.......w.....w
wwwwwwwwwwwwwwww
